minute,h_pts,a_pts,score_diff,home_win,game_id,season
1,2,2,0,0,0029900686,1999-00
2,2,5,-3,0,0029900686,1999-00
3,5,10,-5,0,0029900686,1999-00
4,5,12,-7,0,0029900686,1999-00
5,6,16,-10,0,0029900686,1999-00
6,6,18,-12,0,0029900686,1999-00
7,10,20,-10,0,0029900686,1999-00
8,14,24,-10,0,0029900686,1999-00
9,16,27,-11,0,0029900686,1999-00
10,20,29,-9,0,0029900686,1999-00
11,20,33,-13,0,0029900686,1999-00
12,25,33,-8,0,0029900686,1999-00
13,28,38,-10,0,0029900686,1999-00
14,28,40,-12,0,0029900686,1999-00
15,31,44,-13,0,0029900686,1999-00
16,31,46,-15,0,0029900686,1999-00
17,31,46,-15,0,0029900686,1999-00
18,33,52,-19,0,0029900686,1999-00
19,33,55,-22,0,0029900686,1999-00
20,36,57,-21,0,0029900686,1999-00
21,38,60,-22,0,0029900686,1999-00
22,42,60,-18,0,0029900686,1999-00
23,45,60,-15,0,0029900686,1999-00
24,47,62,-15,0,0029900686,1999-00
25,49,64,-15,0,0029900686,1999-00
26,51,67,-16,0,0029900686,1999-00
27,52,72,-20,0,0029900686,1999-00
28,52,77,-25,0,0029900686,1999-00
29,52,77,-25,0,0029900686,1999-00
30,54,79,-25,0,0029900686,1999-00
31,56,79,-23,0,0029900686,1999-00
32,61,84,-23,0,0029900686,1999-00
33,61,86,-25,0,0029900686,1999-00
34,61,90,-29,0,0029900686,1999-00
35,63,96,-33,0,0029900686,1999-00
36,65,96,-31,0,0029900686,1999-00
37,66,100,-34,0,0029900686,1999-00
38,69,102,-33,0,0029900686,1999-00
39,69,102,-33,0,0029900686,1999-00
40,69,104,-35,0,0029900686,1999-00
41,71,106,-35,0,0029900686,1999-00
42,72,110,-38,0,0029900686,1999-00
43,74,110,-36,0,0029900686,1999-00
44,75,112,-37,0,0029900686,1999-00
45,75,117,-42,0,0029900686,1999-00
46,77,117,-40,0,0029900686,1999-00
47,79,119,-40,0,0029900686,1999-00
48,80,119,-39,0,0029900686,1999-00
49,80,119,-39,0,0029900686,1999-00
1,2,2,0,0,0022000788,2020-21
2,4,7,-3,0,0022000788,2020-21
3,9,9,0,0,0022000788,2020-21
4,11,11,0,0,0022000788,2020-21
5,13,14,-1,0,0022000788,2020-21
6,15,14,1,0,0022000788,2020-21
7,15,16,-1,0,0022000788,2020-21
8,16,16,0,0,0022000788,2020-21
9,19,20,-1,0,0022000788,2020-21
10,21,22,-1,0,0022000788,2020-21
11,23,22,1,0,0022000788,2020-21
12,23,27,-4,0,0022000788,2020-21
13,26,29,-3,0,0022000788,2020-21
14,26,34,-8,0,0022000788,2020-21
15,32,34,-2,0,0022000788,2020-21
16,32,37,-5,0,0022000788,2020-21
17,34,42,-8,0,0022000788,2020-21
18,39,42,-3,0,0022000788,2020-21
19,41,45,-4,0,0022000788,2020-21
20,43,48,-5,0,0022000788,2020-21
21,48,48,0,0,0022000788,2020-21
22,52,49,3,0,0022000788,2020-21
23,52,51,1,0,0022000788,2020-21
24,56,54,2,0,0022000788,2020-21
25,59,56,3,0,0022000788,2020-21
26,63,56,7,0,0022000788,2020-21
27,65,59,6,0,0022000788,2020-21
28,67,64,3,0,0022000788,2020-21
29,67,64,3,0,0022000788,2020-21
30,69,67,2,0,0022000788,2020-21
31,71,70,1,0,0022000788,2020-21
32,73,72,1,0,0022000788,2020-21
33,73,74,-1,0,0022000788,2020-21
34,77,76,1,0,0022000788,2020-21
35,77,81,-4,0,0022000788,2020-21
36,81,83,-2,0,0022000788,2020-21
37,81,83,-2,0,0022000788,2020-21
38,81,87,-6,0,0022000788,2020-21
39,83,90,-7,0,0022000788,2020-21
40,83,93,-10,0,0022000788,2020-21
41,87,93,-6,0,0022000788,2020-21
42,89,95,-6,0,0022000788,2020-21
43,89,100,-11,0,0022000788,2020-21
44,89,103,-14,0,0022000788,2020-21
45,94,105,-11,0,0022000788,2020-21
46,96,110,-14,0,0022000788,2020-21
47,99,113,-14,0,0022000788,2020-21
48,103,113,-10,0,0022000788,2020-21
49,103,113,-10,0,0022000788,2020-21
1,0,2,-2,1,0022101130,2021-22
2,5,4,1,1,0022101130,2021-22
3,8,9,-1,1,0022101130,2021-22
4,11,12,-1,1,0022101130,2021-22
5,13,15,-2,1,0022101130,2021-22
6,19,15,4,1,0022101130,2021-22
7,24,17,7,1,0022101130,2021-22
8,24,23,1,1,0022101130,2021-22
9,26,23,3,1,0022101130,2021-22
10,28,25,3,1,0022101130,2021-22
11,32,25,7,1,0022101130,2021-22
12,34,28,6,1,0022101130,2021-22
13,36,31,5,1,0022101130,2021-22
14,36,35,1,1,0022101130,2021-22
15,39,35,4,1,0022101130,2021-22
16,42,37,5,1,0022101130,2021-22
17,44,42,2,1,0022101130,2021-22
18,49,46,3,1,0022101130,2021-22
19,51,46,5,1,0022101130,2021-22
20,53,48,5,1,0022101130,2021-22
21,53,52,1,1,0022101130,2021-22
22,55,55,0,1,0022101130,2021-22
23,58,57,1,1,0022101130,2021-22
24,58,61,-3,1,0022101130,2021-22
25,58,61,-3,1,0022101130,2021-22
26,61,61,0,1,0022101130,2021-22
27,64,63,1,1,0022101130,2021-22
28,67,65,2,1,0022101130,2021-22
29,67,67,0,1,0022101130,2021-22
30,71,73,-2,1,0022101130,2021-22
31,73,77,-4,1,0022101130,2021-22
32,76,80,-4,1,0022101130,2021-22
33,78,83,-5,1,0022101130,2021-22
34,78,83,-5,1,0022101130,2021-22
35,80,86,-6,1,0022101130,2021-22
36,80,89,-9,1,0022101130,2021-22
37,83,91,-8,1,0022101130,2021-22
38,83,93,-10,1,0022101130,2021-22
39,88,93,-5,1,0022101130,2021-22
40,91,96,-5,1,0022101130,2021-22
41,96,98,-2,1,0022101130,2021-22
42,99,103,-4,1,0022101130,2021-22
43,104,106,-2,1,0022101130,2021-22
44,104,109,-5,1,0022101130,2021-22
45,105,111,-6,1,0022101130,2021-22
46,107,113,-6,1,0022101130,2021-22
47,107,113,-6,1,0022101130,2021-22
48,115,115,0,1,0022101130,2021-22
49,115,115,0,1,0022101130,2021-22
50,115,115,0,1,0022101130,2021-22
51,115,115,0,1,0022101130,2021-22
52,115,115,0,1,0022101130,2021-22
53,115,115,0,1,0022101130,2021-22
54,115,115,0,1,0022101130,2021-22
55,115,115,0,1,0022101130,2021-22
56,115,117,-2,1,0022101130,2021-22
57,118,117,1,1,0022101130,2021-22
58,121,122,-1,1,0022101130,2021-22
59,126,124,2,1,0022101130,2021-22
60,134,131,3,1,0022101130,2021-22
61,134,131,3,1,0022101130,2021-22
1,4,0,4,0,0020000695,2000-01
2,4,4,0,0,0020000695,2000-01
3,8,4,4,0,0020000695,2000-01
4,8,6,2,0,0020000695,2000-01
5,10,8,2,0,0020000695,2000-01
6,14,10,4,0,0020000695,2000-01
7,15,12,3,0,0020000695,2000-01
8,19,12,7,0,0020000695,2000-01
9,21,14,7,0,0020000695,2000-01
10,23,16,7,0,0020000695,2000-01
11,25,16,9,0,0020000695,2000-01
12,25,20,5,0,0020000695,2000-01
13,26,20,6,0,0020000695,2000-01
14,26,24,2,0,0020000695,2000-01
15,32,26,6,0,0020000695,2000-01
16,37,29,8,0,0020000695,2000-01
17,37,31,6,0,0020000695,2000-01
18,39,35,4,0,0020000695,2000-01
19,39,37,2,0,0020000695,2000-01
20,41,39,2,0,0020000695,2000-01
21,41,41,0,0,0020000695,2000-01
22,41,42,-1,0,0020000695,2000-01
23,43,44,-1,0,0020000695,2000-01
24,45,48,-3,0,0020000695,2000-01
25,50,50,0,0,0020000695,2000-01
26,50,50,0,0,0020000695,2000-01
27,50,52,-2,0,0020000695,2000-01
28,50,54,-4,0,0020000695,2000-01
29,50,57,-7,0,0020000695,2000-01
30,50,61,-11,0,0020000695,2000-01
31,50,66,-16,0,0020000695,2000-01
32,55,66,-11,0,0020000695,2000-01
33,57,69,-12,0,0020000695,2000-01
34,57,73,-16,0,0020000695,2000-01
35,57,76,-19,0,0020000695,2000-01
36,59,78,-19,0,0020000695,2000-01
37,59,80,-21,0,0020000695,2000-01
38,59,80,-21,0,0020000695,2000-01
39,62,82,-20,0,0020000695,2000-01
40,63,84,-21,0,0020000695,2000-01
41,65,86,-21,0,0020000695,2000-01
42,67,86,-19,0,0020000695,2000-01
43,70,88,-18,0,0020000695,2000-01
44,74,89,-15,0,0020000695,2000-01
45,74,89,-15,0,0020000695,2000-01
46,76,91,-15,0,0020000695,2000-01
47,76,95,-19,0,0020000695,2000-01
48,80,97,-17,0,0020000695,2000-01
49,80,97,-17,0,0020000695,2000-01
1,0,0,0,0,0020700555,2007-08
2,2,3,-1,0,0020700555,2007-08
3,2,6,-4,0,0020700555,2007-08
4,4,9,-5,0,0020700555,2007-08
5,6,12,-6,0,0020700555,2007-08
6,10,12,-2,0,0020700555,2007-08
7,14,15,-1,0,0020700555,2007-08
8,16,15,1,0,0020700555,2007-08
9,19,19,0,0,0020700555,2007-08
10,19,21,-2,0,0020700555,2007-08
11,20,23,-3,0,0020700555,2007-08
12,27,24,3,0,0020700555,2007-08
13,27,30,-3,0,0020700555,2007-08
14,29,35,-6,0,0020700555,2007-08
15,31,37,-6,0,0020700555,2007-08
16,32,39,-7,0,0020700555,2007-08
17,34,44,-10,0,0020700555,2007-08
18,36,48,-12,0,0020700555,2007-08
19,38,50,-12,0,0020700555,2007-08
20,43,52,-9,0,0020700555,2007-08
21,46,52,-6,0,0020700555,2007-08
22,48,54,-6,0,0020700555,2007-08
23,52,54,-2,0,0020700555,2007-08
24,52,57,-5,0,0020700555,2007-08
25,52,59,-7,0,0020700555,2007-08
26,52,61,-9,0,0020700555,2007-08
27,54,65,-11,0,0020700555,2007-08
28,54,68,-14,0,0020700555,2007-08
29,54,73,-19,0,0020700555,2007-08
30,56,73,-17,0,0020700555,2007-08
31,58,77,-19,0,0020700555,2007-08
32,58,82,-24,0,0020700555,2007-08
33,60,84,-24,0,0020700555,2007-08
34,60,86,-26,0,0020700555,2007-08
35,60,88,-28,0,0020700555,2007-08
36,62,89,-27,0,0020700555,2007-08
37,66,89,-23,0,0020700555,2007-08
38,66,91,-25,0,0020700555,2007-08
39,67,91,-24,0,0020700555,2007-08
40,69,94,-25,0,0020700555,2007-08
41,73,97,-24,0,0020700555,2007-08
42,75,97,-22,0,0020700555,2007-08
43,79,97,-18,0,0020700555,2007-08
44,79,100,-21,0,0020700555,2007-08
45,84,100,-16,0,0020700555,2007-08
46,86,100,-14,0,0020700555,2007-08
47,88,102,-14,0,0020700555,2007-08
48,88,102,-14,0,0020700555,2007-08
49,88,102,-14,0,0020700555,2007-08
1,3,0,3,0,0021300756,2013-14
2,3,0,3,0,0021300756,2013-14
3,6,4,2,0,0021300756,2013-14
4,11,7,4,0,0021300756,2013-14
5,11,9,2,0,0021300756,2013-14
6,16,13,3,0,0021300756,2013-14
7,19,16,3,0,0021300756,2013-14
8,19,18,1,0,0021300756,2013-14
9,21,22,-1,0,0021300756,2013-14
10,24,22,2,0,0021300756,2013-14
11,26,27,-1,0,0021300756,2013-14
12,28,29,-1,0,0021300756,2013-14
13,28,32,-4,0,0021300756,2013-14
14,30,34,-4,0,0021300756,2013-14
15,35,36,-1,0,0021300756,2013-14
16,35,39,-4,0,0021300756,2013-14
17,39,41,-2,0,0021300756,2013-14
18,40,44,-4,0,0021300756,2013-14
19,42,46,-4,0,0021300756,2013-14
20,44,49,-5,0,0021300756,2013-14
21,48,51,-3,0,0021300756,2013-14
22,50,55,-5,0,0021300756,2013-14
23,53,55,-2,0,0021300756,2013-14
24,53,58,-5,0,0021300756,2013-14
25,55,58,-3,0,0021300756,2013-14
26,57,61,-4,0,0021300756,2013-14
27,60,64,-4,0,0021300756,2013-14
28,60,69,-9,0,0021300756,2013-14
29,60,71,-11,0,0021300756,2013-14
30,64,73,-9,0,0021300756,2013-14
31,66,76,-10,0,0021300756,2013-14
32,69,76,-7,0,0021300756,2013-14
33,69,81,-12,0,0021300756,2013-14
34,72,81,-9,0,0021300756,2013-14
35,74,84,-10,0,0021300756,2013-14
36,76,86,-10,0,0021300756,2013-14
37,78,86,-8,0,0021300756,2013-14
38,82,88,-6,0,0021300756,2013-14
39,84,90,-6,0,0021300756,2013-14
40,86,95,-9,0,0021300756,2013-14
41,86,97,-11,0,0021300756,2013-14
42,86,97,-11,0,0021300756,2013-14
43,89,99,-10,0,0021300756,2013-14
44,89,101,-12,0,0021300756,2013-14
45,90,103,-13,0,0021300756,2013-14
46,92,105,-13,0,0021300756,2013-14
47,96,108,-12,0,0021300756,2013-14
48,100,112,-12,0,0021300756,2013-14
49,100,112,-12,0,0021300756,2013-14
1,0,2,-2,0,0021000125,2010-11
2,2,4,-2,0,0021000125,2010-11
3,4,6,-2,0,0021000125,2010-11
4,12,6,6,0,0021000125,2010-11
5,17,8,9,0,0021000125,2010-11
6,19,12,7,0,0021000125,2010-11
7,19,14,5,0,0021000125,2010-11
8,21,16,5,0,0021000125,2010-11
9,23,20,3,0,0021000125,2010-11
10,25,25,0,0,0021000125,2010-11
11,25,25,0,0,0021000125,2010-11
12,30,27,3,0,0021000125,2010-11
13,36,30,6,0,0021000125,2010-11
14,38,30,8,0,0021000125,2010-11
15,38,32,6,0,0021000125,2010-11
16,43,36,7,0,0021000125,2010-11
17,43,36,7,0,0021000125,2010-11
18,48,38,10,0,0021000125,2010-11
19,51,40,11,0,0021000125,2010-11
20,54,44,10,0,0021000125,2010-11
21,58,44,14,0,0021000125,2010-11
22,58,47,11,0,0021000125,2010-11
23,63,49,14,0,0021000125,2010-11
24,65,51,14,0,0021000125,2010-11
25,67,53,14,0,0021000125,2010-11
26,72,55,17,0,0021000125,2010-11
27,78,57,21,0,0021000125,2010-11
28,78,62,16,0,0021000125,2010-11
29,80,67,13,0,0021000125,2010-11
30,83,69,14,0,0021000125,2010-11
31,83,71,12,0,0021000125,2010-11
32,83,73,10,0,0021000125,2010-11
33,85,75,10,0,0021000125,2010-11
34,85,76,9,0,0021000125,2010-11
35,85,76,9,0,0021000125,2010-11
36,87,80,7,0,0021000125,2010-11
37,87,83,4,0,0021000125,2010-11
38,87,87,0,0,0021000125,2010-11
39,87,90,-3,0,0021000125,2010-11
40,91,90,1,0,0021000125,2010-11
41,91,94,-3,0,0021000125,2010-11
42,91,97,-6,0,0021000125,2010-11
43,91,97,-6,0,0021000125,2010-11
44,94,99,-5,0,0021000125,2010-11
45,94,103,-9,0,0021000125,2010-11
46,99,106,-7,0,0021000125,2010-11
47,101,111,-10,0,0021000125,2010-11
48,103,112,-9,0,0021000125,2010-11
49,103,112,-9,0,0021000125,2010-11
1,2,0,2,0,0020400512,2004-05
2,2,0,2,0,0020400512,2004-05
3,2,4,-2,0,0020400512,2004-05
4,6,6,0,0,0020400512,2004-05
5,8,7,1,0,0020400512,2004-05
6,10,9,1,0,0020400512,2004-05
7,12,13,-1,0,0020400512,2004-05
8,14,15,-1,0,0020400512,2004-05
9,14,17,-3,0,0020400512,2004-05
10,16,21,-5,0,0020400512,2004-05
11,21,23,-2,0,0020400512,2004-05
12,21,23,-2,0,0020400512,2004-05
13,21,23,-2,0,0020400512,2004-05
14,24,23,1,0,0020400512,2004-05
15,24,25,-1,0,0020400512,2004-05
16,24,27,-3,0,0020400512,2004-05
17,24,30,-6,0,0020400512,2004-05
18,25,35,-10,0,0020400512,2004-05
19,25,39,-14,0,0020400512,2004-05
20,27,41,-14,0,0020400512,2004-05
21,28,43,-15,0,0020400512,2004-05
22,30,45,-15,0,0020400512,2004-05
23,32,47,-15,0,0020400512,2004-05
24,35,49,-14,0,0020400512,2004-05
25,37,51,-14,0,0020400512,2004-05
26,37,53,-16,0,0020400512,2004-05
27,41,59,-18,0,0020400512,2004-05
28,46,60,-14,0,0020400512,2004-05
29,46,62,-16,0,0020400512,2004-05
30,46,64,-18,0,0020400512,2004-05
31,48,68,-20,0,0020400512,2004-05
32,53,68,-15,0,0020400512,2004-05
33,53,70,-17,0,0020400512,2004-05
34,56,70,-14,0,0020400512,2004-05
35,58,74,-16,0,0020400512,2004-05
36,62,74,-12,0,0020400512,2004-05
37,62,76,-14,0,0020400512,2004-05
38,64,76,-12,0,0020400512,2004-05
39,64,78,-14,0,0020400512,2004-05
40,64,80,-16,0,0020400512,2004-05
41,65,83,-18,0,0020400512,2004-05
42,68,85,-17,0,0020400512,2004-05
43,71,87,-16,0,0020400512,2004-05
44,75,89,-14,0,0020400512,2004-05
45,77,91,-14,0,0020400512,2004-05
46,77,93,-16,0,0020400512,2004-05
47,81,93,-12,0,0020400512,2004-05
48,83,95,-12,0,0020400512,2004-05
49,83,95,-12,0,0020400512,2004-05
1,2,3,-1,1,0021800323,2018-19
2,4,3,1,1,0021800323,2018-19
3,4,5,-1,1,0021800323,2018-19
4,4,7,-3,1,0021800323,2018-19
5,8,9,-1,1,0021800323,2018-19
6,13,11,2,1,0021800323,2018-19
7,17,13,4,1,0021800323,2018-19
8,17,15,2,1,0021800323,2018-19
9,19,17,2,1,0021800323,2018-19
10,24,17,7,1,0021800323,2018-19
11,24,20,4,1,0021800323,2018-19
12,26,26,0,1,0021800323,2018-19
13,28,26,2,1,0021800323,2018-19
14,32,26,6,1,0021800323,2018-19
15,36,34,2,1,0021800323,2018-19
16,38,34,4,1,0021800323,2018-19
17,42,39,3,1,0021800323,2018-19
18,45,39,6,1,0021800323,2018-19
19,45,44,1,1,0021800323,2018-19
20,50,44,6,1,0021800323,2018-19
21,50,48,2,1,0021800323,2018-19
22,52,51,1,1,0021800323,2018-19
23,55,54,1,1,0021800323,2018-19
24,58,58,0,1,0021800323,2018-19
25,60,58,2,1,0021800323,2018-19
26,64,58,6,1,0021800323,2018-19
27,64,63,1,1,0021800323,2018-19
28,64,66,-2,1,0021800323,2018-19
29,69,68,1,1,0021800323,2018-19
30,69,70,-1,1,0021800323,2018-19
31,73,70,3,1,0021800323,2018-19
32,77,75,2,1,0021800323,2018-19
33,79,77,2,1,0021800323,2018-19
34,81,79,2,1,0021800323,2018-19
35,82,79,3,1,0021800323,2018-19
36,85,80,5,1,0021800323,2018-19
37,87,83,4,1,0021800323,2018-19
38,87,85,2,1,0021800323,2018-19
39,87,89,-2,1,0021800323,2018-19
40,87,92,-5,1,0021800323,2018-19
41,90,94,-4,1,0021800323,2018-19
42,90,96,-6,1,0021800323,2018-19
43,92,99,-7,1,0021800323,2018-19
44,92,99,-7,1,0021800323,2018-19
45,95,102,-7,1,0021800323,2018-19
46,98,104,-6,1,0021800323,2018-19
47,102,108,-6,1,0021800323,2018-19
48,111,111,0,1,0021800323,2018-19
49,111,111,0,1,0021800323,2018-19
50,111,111,0,1,0021800323,2018-19
51,111,111,0,1,0021800323,2018-19
52,111,111,0,1,0021800323,2018-19
53,111,111,0,1,0021800323,2018-19
54,111,111,0,1,0021800323,2018-19
55,111,111,0,1,0021800323,2018-19
56,111,115,-4,1,0021800323,2018-19
57,113,115,-2,1,0021800323,2018-19
58,113,117,-4,1,0021800323,2018-19
59,113,117,-4,1,0021800323,2018-19
60,117,117,0,1,0021800323,2018-19
61,117,117,0,1,0021800323,2018-19
62,117,117,0,1,0021800323,2018-19
63,117,117,0,1,0021800323,2018-19
64,117,117,0,1,0021800323,2018-19
65,117,117,0,1,0021800323,2018-19
66,117,117,0,1,0021800323,2018-19
67,117,117,0,1,0021800323,2018-19
68,121,117,4,1,0021800323,2018-19
69,124,123,1,1,0021800323,2018-19
70,126,125,1,1,0021800323,2018-19
71,126,125,1,1,0021800323,2018-19
72,131,125,6,1,0021800323,2018-19
73,131,125,6,1,0021800323,2018-19
1,2,3,-1,0,0029700032,1997-98
2,5,5,0,0,0029700032,1997-98
3,9,5,4,0,0029700032,1997-98
4,12,7,5,0,0029700032,1997-98
5,13,11,2,0,0029700032,1997-98
6,13,13,0,0,0029700032,1997-98
7,13,15,-2,0,0029700032,1997-98
8,14,17,-3,0,0029700032,1997-98
9,16,17,-1,0,0029700032,1997-98
10,18,20,-2,0,0029700032,1997-98
11,20,21,-1,0,0029700032,1997-98
12,22,23,-1,0,0029700032,1997-98
13,22,26,-4,0,0029700032,1997-98
14,24,31,-7,0,0029700032,1997-98
15,29,31,-2,0,0029700032,1997-98
16,31,31,0,0,0029700032,1997-98
17,31,35,-4,0,0029700032,1997-98
18,31,38,-7,0,0029700032,1997-98
19,31,40,-9,0,0029700032,1997-98
20,33,44,-11,0,0029700032,1997-98
21,35,44,-9,0,0029700032,1997-98
22,35,46,-11,0,0029700032,1997-98
23,35,50,-15,0,0029700032,1997-98
24,39,56,-17,0,0029700032,1997-98
25,39,58,-19,0,0029700032,1997-98
26,41,62,-21,0,0029700032,1997-98
27,46,63,-17,0,0029700032,1997-98
28,47,65,-18,0,0029700032,1997-98
29,49,65,-16,0,0029700032,1997-98
30,49,69,-20,0,0029700032,1997-98
31,51,69,-18,0,0029700032,1997-98
32,53,73,-20,0,0029700032,1997-98
33,57,74,-17,0,0029700032,1997-98
34,57,79,-22,0,0029700032,1997-98
35,57,79,-22,0,0029700032,1997-98
36,57,83,-26,0,0029700032,1997-98
37,59,86,-27,0,0029700032,1997-98
38,61,86,-25,0,0029700032,1997-98
39,63,88,-25,0,0029700032,1997-98
40,63,88,-25,0,0029700032,1997-98
41,63,88,-25,0,0029700032,1997-98
42,66,90,-24,0,0029700032,1997-98
43,66,94,-28,0,0029700032,1997-98
44,66,96,-30,0,0029700032,1997-98
45,68,98,-30,0,0029700032,1997-98
46,68,100,-32,0,0029700032,1997-98
47,68,102,-34,0,0029700032,1997-98
48,70,102,-32,0,0029700032,1997-98
49,70,102,-32,0,0029700032,1997-98
1,2,3,-1,1,0021900514,2019-20
2,4,3,1,1,0021900514,2019-20
3,4,9,-5,1,0021900514,2019-20
4,9,11,-2,1,0021900514,2019-20
5,13,16,-3,1,0021900514,2019-20
6,16,18,-2,1,0021900514,2019-20
7,18,20,-2,1,0021900514,2019-20
8,18,20,-2,1,0021900514,2019-20
9,20,23,-3,1,0021900514,2019-20
10,22,23,-1,1,0021900514,2019-20
11,25,27,-2,1,0021900514,2019-20
12,27,27,0,1,0021900514,2019-20
13,30,27,3,1,0021900514,2019-20
14,30,35,-5,1,0021900514,2019-20
15,30,39,-9,1,0021900514,2019-20
16,30,42,-12,1,0021900514,2019-20
17,33,44,-11,1,0021900514,2019-20
18,37,46,-9,1,0021900514,2019-20
19,39,48,-9,1,0021900514,2019-20
20,39,51,-12,1,0021900514,2019-20
21,44,51,-7,1,0021900514,2019-20
22,44,51,-7,1,0021900514,2019-20
23,46,53,-7,1,0021900514,2019-20
24,46,55,-9,1,0021900514,2019-20
25,51,55,-4,1,0021900514,2019-20
26,51,58,-7,1,0021900514,2019-20
27,55,60,-5,1,0021900514,2019-20
28,57,60,-3,1,0021900514,2019-20
29,59,63,-4,1,0021900514,2019-20
30,63,65,-2,1,0021900514,2019-20
31,67,67,0,1,0021900514,2019-20
32,70,69,1,1,0021900514,2019-20
33,72,72,0,1,0021900514,2019-20
34,72,74,-2,1,0021900514,2019-20
35,72,76,-4,1,0021900514,2019-20
36,74,76,-2,1,0021900514,2019-20
37,77,76,1,1,0021900514,2019-20
38,79,80,-1,1,0021900514,2019-20
39,81,80,1,1,0021900514,2019-20
40,87,83,4,1,0021900514,2019-20
41,90,85,5,1,0021900514,2019-20
42,92,85,7,1,0021900514,2019-20
43,94,89,5,1,0021900514,2019-20
44,97,93,4,1,0021900514,2019-20
45,99,93,6,1,0021900514,2019-20
46,103,93,10,1,0021900514,2019-20
47,105,99,6,1,0021900514,2019-20
48,109,103,6,1,0021900514,2019-20
49,109,103,6,1,0021900514,2019-20
1,3,2,1,1,0029600158,1996-97
2,6,4,2,1,0029600158,1996-97
3,8,8,0,1,0029600158,1996-97
4,10,10,0,1,0029600158,1996-97
5,12,16,-4,1,0029600158,1996-97
6,13,16,-3,1,0029600158,1996-97
7,15,16,-1,1,0029600158,1996-97
8,17,16,1,1,0029600158,1996-97
9,17,18,-1,1,0029600158,1996-97
10,18,20,-2,1,0029600158,1996-97
11,18,20,-2,1,0029600158,1996-97
12,18,24,-6,1,0029600158,1996-97
13,22,24,-2,1,0029600158,1996-97
14,25,24,1,1,0029600158,1996-97
15,25,24,1,1,0029600158,1996-97
16,27,24,3,1,0029600158,1996-97
17,29,26,3,1,0029600158,1996-97
18,29,28,1,1,0029600158,1996-97
19,31,30,1,1,0029600158,1996-97
20,35,30,5,1,0029600158,1996-97
21,39,32,7,1,0029600158,1996-97
22,42,34,8,1,0029600158,1996-97
23,48,38,10,1,0029600158,1996-97
24,50,40,10,1,0029600158,1996-97
25,50,40,10,1,0029600158,1996-97
26,53,43,10,1,0029600158,1996-97
27,56,46,10,1,0029600158,1996-97
28,56,49,7,1,0029600158,1996-97
29,58,51,7,1,0029600158,1996-97
30,60,51,9,1,0029600158,1996-97
31,62,54,8,1,0029600158,1996-97
32,63,56,7,1,0029600158,1996-97
33,66,56,10,1,0029600158,1996-97
34,68,56,12,1,0029600158,1996-97
35,68,59,9,1,0029600158,1996-97
36,68,61,7,1,0029600158,1996-97
37,71,66,5,1,0029600158,1996-97
38,74,67,7,1,0029600158,1996-97
39,75,69,6,1,0029600158,1996-97
40,77,71,6,1,0029600158,1996-97
41,79,74,5,1,0029600158,1996-97
42,79,74,5,1,0029600158,1996-97
43,81,76,5,1,0029600158,1996-97
44,85,81,4,1,0029600158,1996-97
45,87,86,1,1,0029600158,1996-97
46,89,86,3,1,0029600158,1996-97
47,89,88,1,1,0029600158,1996-97
48,90,90,0,1,0029600158,1996-97
49,90,90,0,1,0029600158,1996-97
50,90,90,0,1,0029600158,1996-97
51,90,90,0,1,0029600158,1996-97
52,90,90,0,1,0029600158,1996-97
53,90,90,0,1,0029600158,1996-97
54,90,90,0,1,0029600158,1996-97
55,90,90,0,1,0029600158,1996-97
56,90,91,-1,1,0029600158,1996-97
57,93,93,0,1,0029600158,1996-97
58,93,93,0,1,0029600158,1996-97
59,98,95,3,1,0029600158,1996-97
60,100,100,0,1,0029600158,1996-97
61,100,100,0,1,0029600158,1996-97
62,100,100,0,1,0029600158,1996-97
63,100,100,0,1,0029600158,1996-97
64,100,100,0,1,0029600158,1996-97
65,100,100,0,1,0029600158,1996-97
66,100,100,0,1,0029600158,1996-97
67,100,100,0,1,0029600158,1996-97
68,100,100,0,1,0029600158,1996-97
69,102,102,0,1,0029600158,1996-97
70,102,104,-2,1,0029600158,1996-97
71,104,106,-2,1,0029600158,1996-97
72,111,108,3,1,0029600158,1996-97
73,111,108,3,1,0029600158,1996-97
1,0,2,-2,0,0021201014,2012-13
2,0,4,-4,0,0021201014,2012-13
3,2,8,-6,0,0021201014,2012-13
4,4,8,-4,0,0021201014,2012-13
5,6,10,-4,0,0021201014,2012-13
6,10,16,-6,0,0021201014,2012-13
7,10,16,-6,0,0021201014,2012-13
8,13,18,-5,0,0021201014,2012-13
9,15,20,-5,0,0021201014,2012-13
10,15,20,-5,0,0021201014,2012-13
11,15,23,-8,0,0021201014,2012-13
12,17,25,-8,0,0021201014,2012-13
13,19,27,-8,0,0021201014,2012-13
14,19,29,-10,0,0021201014,2012-13
15,19,31,-12,0,0021201014,2012-13
16,22,37,-15,0,0021201014,2012-13
17,22,37,-15,0,0021201014,2012-13
18,24,41,-17,0,0021201014,2012-13
19,26,43,-17,0,0021201014,2012-13
20,28,48,-20,0,0021201014,2012-13
21,30,50,-20,0,0021201014,2012-13
22,30,52,-22,0,0021201014,2012-13
23,33,52,-19,0,0021201014,2012-13
24,33,52,-19,0,0021201014,2012-13
25,35,55,-20,0,0021201014,2012-13
26,37,59,-22,0,0021201014,2012-13
27,41,61,-20,0,0021201014,2012-13
28,41,64,-23,0,0021201014,2012-13
29,41,64,-23,0,0021201014,2012-13
30,45,69,-24,0,0021201014,2012-13
31,48,71,-23,0,0021201014,2012-13
32,50,71,-21,0,0021201014,2012-13
33,54,72,-18,0,0021201014,2012-13
34,57,76,-19,0,0021201014,2012-13
35,59,78,-19,0,0021201014,2012-13
36,59,80,-21,0,0021201014,2012-13
37,63,83,-20,0,0021201014,2012-13
38,65,84,-19,0,0021201014,2012-13
39,67,84,-17,0,0021201014,2012-13
40,67,84,-17,0,0021201014,2012-13
41,72,84,-12,0,0021201014,2012-13
42,74,87,-13,0,0021201014,2012-13
43,76,87,-11,0,0021201014,2012-13
44,79,89,-10,0,0021201014,2012-13
45,81,91,-10,0,0021201014,2012-13
46,84,93,-9,0,0021201014,2012-13
47,88,95,-7,0,0021201014,2012-13
48,93,100,-7,0,0021201014,2012-13
49,93,100,-7,0,0021201014,2012-13
1,2,0,2,0,0020900401,2009-10
2,4,2,2,0,0020900401,2009-10
3,4,4,0,0,0020900401,2009-10
4,4,6,-2,0,0020900401,2009-10
5,6,6,0,0,0020900401,2009-10
6,6,8,-2,0,0020900401,2009-10
7,8,8,0,0,0020900401,2009-10
8,11,8,3,0,0020900401,2009-10
9,11,11,0,0,0020900401,2009-10
10,14,14,0,0,0020900401,2009-10
11,16,14,2,0,0020900401,2009-10
12,18,19,-1,0,0020900401,2009-10
13,18,20,-2,0,0020900401,2009-10
14,23,22,1,0,0020900401,2009-10
15,23,26,-3,0,0020900401,2009-10
16,23,26,-3,0,0020900401,2009-10
17,23,28,-5,0,0020900401,2009-10
18,28,28,0,0,0020900401,2009-10
19,28,34,-6,0,0020900401,2009-10
20,28,36,-8,0,0020900401,2009-10
21,30,39,-9,0,0020900401,2009-10
22,33,39,-6,0,0020900401,2009-10
23,36,39,-3,0,0020900401,2009-10
24,40,40,0,0,0020900401,2009-10
25,42,41,1,0,0020900401,2009-10
26,42,43,-1,0,0020900401,2009-10
27,46,45,1,0,0020900401,2009-10
28,48,47,1,0,0020900401,2009-10
29,48,51,-3,0,0020900401,2009-10
30,54,54,0,0,0020900401,2009-10
31,56,56,0,0,0020900401,2009-10
32,61,59,2,0,0020900401,2009-10
33,63,62,1,0,0020900401,2009-10
34,63,67,-4,0,0020900401,2009-10
35,64,70,-6,0,0020900401,2009-10
36,68,70,-2,0,0020900401,2009-10
37,70,72,-2,0,0020900401,2009-10
38,70,75,-5,0,0020900401,2009-10
39,77,75,2,0,0020900401,2009-10
40,78,79,-1,0,0020900401,2009-10
41,84,82,2,0,0020900401,2009-10
42,86,84,2,0,0020900401,2009-10
43,86,89,-3,0,0020900401,2009-10
44,86,92,-6,0,0020900401,2009-10
45,91,94,-3,0,0020900401,2009-10
46,94,98,-4,0,0020900401,2009-10
47,94,98,-4,0,0020900401,2009-10
48,96,104,-8,0,0020900401,2009-10
49,99,104,-5,0,0020900401,2009-10
1,2,0,2,1,0020600209,2006-07
2,2,4,-2,1,0020600209,2006-07
3,4,8,-4,1,0020600209,2006-07
4,4,8,-4,1,0020600209,2006-07
5,4,10,-6,1,0020600209,2006-07
6,6,10,-4,1,0020600209,2006-07
7,6,13,-7,1,0020600209,2006-07
8,6,16,-10,1,0020600209,2006-07
9,8,18,-10,1,0020600209,2006-07
10,10,19,-9,1,0020600209,2006-07
11,12,21,-9,1,0020600209,2006-07
12,17,25,-8,1,0020600209,2006-07
13,19,27,-8,1,0020600209,2006-07
14,21,29,-8,1,0020600209,2006-07
15,23,32,-9,1,0020600209,2006-07
16,25,34,-9,1,0020600209,2006-07
17,31,34,-3,1,0020600209,2006-07
18,35,34,1,1,0020600209,2006-07
19,40,36,4,1,0020600209,2006-07
20,40,40,0,1,0020600209,2006-07
21,44,42,2,1,0020600209,2006-07
22,49,44,5,1,0020600209,2006-07
23,51,48,3,1,0020600209,2006-07
24,53,52,1,1,0020600209,2006-07
25,55,56,-1,1,0020600209,2006-07
26,55,58,-3,1,0020600209,2006-07
27,59,60,-1,1,0020600209,2006-07
28,62,63,-1,1,0020600209,2006-07
29,68,67,1,1,0020600209,2006-07
30,70,69,1,1,0020600209,2006-07
31,75,69,6,1,0020600209,2006-07
32,75,71,4,1,0020600209,2006-07
33,75,75,0,1,0020600209,2006-07
34,75,77,-2,1,0020600209,2006-07
35,77,80,-3,1,0020600209,2006-07
36,81,80,1,1,0020600209,2006-07
37,83,82,1,1,0020600209,2006-07
38,87,82,5,1,0020600209,2006-07
39,89,82,7,1,0020600209,2006-07
40,89,82,7,1,0020600209,2006-07
41,91,83,8,1,0020600209,2006-07
42,95,85,10,1,0020600209,2006-07
43,99,87,12,1,0020600209,2006-07
44,102,89,13,1,0020600209,2006-07
45,102,92,10,1,0020600209,2006-07
46,104,92,12,1,0020600209,2006-07
47,106,94,12,1,0020600209,2006-07
48,108,96,12,1,0020600209,2006-07
49,108,96,12,1,0020600209,2006-07
1,0,0,0,0,0020500560,2005-06
2,4,2,2,0,0020500560,2005-06
3,6,4,2,0,0020500560,2005-06
4,8,8,0,0,0020500560,2005-06
5,8,11,-3,0,0020500560,2005-06
6,11,15,-4,0,0020500560,2005-06
7,11,19,-8,0,0020500560,2005-06
8,14,21,-7,0,0020500560,2005-06
9,18,21,-3,0,0020500560,2005-06
10,19,23,-4,0,0020500560,2005-06
11,21,25,-4,0,0020500560,2005-06
12,24,27,-3,0,0020500560,2005-06
13,24,28,-4,0,0020500560,2005-06
14,27,30,-3,0,0020500560,2005-06
15,29,30,-1,0,0020500560,2005-06
16,31,32,-1,0,0020500560,2005-06
17,33,35,-2,0,0020500560,2005-06
18,36,37,-1,0,0020500560,2005-06
19,40,37,3,0,0020500560,2005-06
20,43,41,2,0,0020500560,2005-06
21,45,45,0,0,0020500560,2005-06
22,47,47,0,0,0020500560,2005-06
23,49,49,0,0,0020500560,2005-06
24,49,52,-3,0,0020500560,2005-06
25,49,52,-3,0,0020500560,2005-06
26,51,52,-1,0,0020500560,2005-06
27,53,56,-3,0,0020500560,2005-06
28,53,58,-5,0,0020500560,2005-06
29,55,60,-5,0,0020500560,2005-06
30,56,62,-6,0,0020500560,2005-06
31,56,67,-11,0,0020500560,2005-06
32,56,71,-15,0,0020500560,2005-06
33,59,73,-14,0,0020500560,2005-06
34,61,75,-14,0,0020500560,2005-06
35,63,75,-12,0,0020500560,2005-06
36,66,77,-11,0,0020500560,2005-06
37,66,80,-14,0,0020500560,2005-06
38,69,84,-15,0,0020500560,2005-06
39,72,86,-14,0,0020500560,2005-06
40,74,86,-12,0,0020500560,2005-06
41,79,86,-7,0,0020500560,2005-06
42,81,87,-6,0,0020500560,2005-06
43,81,89,-8,0,0020500560,2005-06
44,83,89,-6,0,0020500560,2005-06
45,85,89,-4,0,0020500560,2005-06
46,88,91,-3,0,0020500560,2005-06
47,90,91,-1,0,0020500560,2005-06
48,94,96,-2,0,0020500560,2005-06
49,94,96,-2,0,0020500560,2005-06
1,2,2,0,0,0021801084,2018-19
2,2,2,0,0,0021801084,2018-19
3,4,7,-3,0,0021801084,2018-19
4,7,9,-2,0,0021801084,2018-19
5,9,14,-5,0,0021801084,2018-19
6,14,16,-2,0,0021801084,2018-19
7,17,21,-4,0,0021801084,2018-19
8,17,26,-9,0,0021801084,2018-19
9,17,28,-11,0,0021801084,2018-19
10,19,33,-14,0,0021801084,2018-19
11,21,35,-14,0,0021801084,2018-19
12,24,36,-12,0,0021801084,2018-19
13,25,37,-12,0,0021801084,2018-19
14,28,39,-11,0,0021801084,2018-19
15,34,42,-8,0,0021801084,2018-19
16,36,44,-8,0,0021801084,2018-19
17,36,44,-8,0,0021801084,2018-19
18,38,46,-8,0,0021801084,2018-19
19,40,46,-6,0,0021801084,2018-19
20,40,49,-9,0,0021801084,2018-19
21,43,52,-9,0,0021801084,2018-19
22,43,54,-11,0,0021801084,2018-19
23,47,57,-10,0,0021801084,2018-19
24,47,62,-15,0,0021801084,2018-19
25,47,64,-17,0,0021801084,2018-19
26,51,66,-15,0,0021801084,2018-19
27,54,66,-12,0,0021801084,2018-19
28,56,69,-13,0,0021801084,2018-19
29,61,69,-8,0,0021801084,2018-19
30,67,72,-5,0,0021801084,2018-19
31,67,74,-7,0,0021801084,2018-19
32,67,76,-9,0,0021801084,2018-19
33,70,76,-6,0,0021801084,2018-19
34,72,78,-6,0,0021801084,2018-19
35,74,81,-7,0,0021801084,2018-19
36,79,81,-2,0,0021801084,2018-19
37,83,84,-1,0,0021801084,2018-19
38,87,86,1,0,0021801084,2018-19
39,89,89,0,0,0021801084,2018-19
40,94,91,3,0,0021801084,2018-19
41,94,91,3,0,0021801084,2018-19
42,96,93,3,0,0021801084,2018-19
43,98,94,4,0,0021801084,2018-19
44,100,94,6,0,0021801084,2018-19
45,100,100,0,0,0021801084,2018-19
46,102,103,-1,0,0021801084,2018-19
47,102,107,-5,0,0021801084,2018-19
48,105,111,-6,0,0021801084,2018-19
49,105,111,-6,0,0021801084,2018-19
1,0,0,0,0,0022200520,2022-23
2,5,0,5,0,0022200520,2022-23
3,5,3,2,0,0022200520,2022-23
4,7,5,2,0,0022200520,2022-23
5,9,10,-1,0,0022200520,2022-23
6,12,14,-2,0,0022200520,2022-23
7,14,16,-2,0,0022200520,2022-23
8,18,19,-1,0,0022200520,2022-23
9,21,22,-1,0,0022200520,2022-23
10,25,23,2,0,0022200520,2022-23
11,27,23,4,0,0022200520,2022-23
12,28,24,4,0,0022200520,2022-23
13,28,26,2,0,0022200520,2022-23
14,30,31,-1,0,0022200520,2022-23
15,32,31,1,0,0022200520,2022-23
16,37,34,3,0,0022200520,2022-23
17,37,34,3,0,0022200520,2022-23
18,39,34,5,0,0022200520,2022-23
19,41,39,2,0,0022200520,2022-23
20,46,39,7,0,0022200520,2022-23
21,50,41,9,0,0022200520,2022-23
22,50,43,7,0,0022200520,2022-23
23,52,48,4,0,0022200520,2022-23
24,55,49,6,0,0022200520,2022-23
25,58,52,6,0,0022200520,2022-23
26,61,57,4,0,0022200520,2022-23
27,64,60,4,0,0022200520,2022-23
28,69,60,9,0,0022200520,2022-23
29,72,62,10,0,0022200520,2022-23
30,73,69,4,0,0022200520,2022-23
31,78,71,7,0,0022200520,2022-23
32,81,73,8,0,0022200520,2022-23
33,83,79,4,0,0022200520,2022-23
34,86,79,7,0,0022200520,2022-23
35,88,83,5,0,0022200520,2022-23
36,88,86,2,0,0022200520,2022-23
37,88,91,-3,0,0022200520,2022-23
38,91,91,0,0,0022200520,2022-23
39,93,94,-1,0,0022200520,2022-23
40,95,96,-1,0,0022200520,2022-23
41,99,98,1,0,0022200520,2022-23
42,104,100,4,0,0022200520,2022-23
43,104,102,2,0,0022200520,2022-23
44,106,103,3,0,0022200520,2022-23
45,110,105,5,0,0022200520,2022-23
46,112,110,2,0,0022200520,2022-23
47,116,114,2,0,0022200520,2022-23
48,118,119,-1,0,0022200520,2022-23
49,118,119,-1,0,0022200520,2022-23
1,0,2,-2,0,0021400786,2014-15
2,5,4,1,0,0021400786,2014-15
3,5,10,-5,0,0021400786,2014-15
4,5,12,-7,0,0021400786,2014-15
5,7,12,-5,0,0021400786,2014-15
6,7,16,-9,0,0021400786,2014-15
7,9,18,-9,0,0021400786,2014-15
8,9,20,-11,0,0021400786,2014-15
9,11,22,-11,0,0021400786,2014-15
10,11,26,-15,0,0021400786,2014-15
11,11,28,-17,0,0021400786,2014-15
12,15,32,-17,0,0021400786,2014-15
13,17,33,-16,0,0021400786,2014-15
14,17,35,-18,0,0021400786,2014-15
15,18,38,-20,0,0021400786,2014-15
16,20,40,-20,0,0021400786,2014-15
17,20,40,-20,0,0021400786,2014-15
18,27,43,-16,0,0021400786,2014-15
19,32,43,-11,0,0021400786,2014-15
20,34,45,-11,0,0021400786,2014-15
21,36,47,-11,0,0021400786,2014-15
22,36,49,-13,0,0021400786,2014-15
23,38,50,-12,0,0021400786,2014-15
24,40,52,-12,0,0021400786,2014-15
25,40,52,-12,0,0021400786,2014-15
26,40,52,-12,0,0021400786,2014-15
27,41,60,-19,0,0021400786,2014-15
28,43,60,-17,0,0021400786,2014-15
29,45,62,-17,0,0021400786,2014-15
30,49,62,-13,0,0021400786,2014-15
31,51,67,-16,0,0021400786,2014-15
32,51,68,-17,0,0021400786,2014-15
33,51,71,-20,0,0021400786,2014-15
34,55,73,-18,0,0021400786,2014-15
35,59,73,-14,0,0021400786,2014-15
36,62,75,-13,0,0021400786,2014-15
37,62,77,-15,0,0021400786,2014-15
38,62,78,-16,0,0021400786,2014-15
39,64,78,-14,0,0021400786,2014-15
40,69,78,-9,0,0021400786,2014-15
41,69,83,-14,0,0021400786,2014-15
42,71,85,-14,0,0021400786,2014-15
43,73,88,-15,0,0021400786,2014-15
44,73,88,-15,0,0021400786,2014-15
45,77,90,-13,0,0021400786,2014-15
46,80,90,-10,0,0021400786,2014-15
47,84,91,-7,0,0021400786,2014-15
48,86,95,-9,0,0021400786,2014-15
49,86,95,-9,0,0021400786,2014-15
1,0,2,-2,0,0020600060,2006-07
2,0,7,-7,0,0020600060,2006-07
3,0,11,-11,0,0020600060,2006-07
4,2,13,-11,0,0020600060,2006-07
5,5,13,-8,0,0020600060,2006-07
6,7,15,-8,0,0020600060,2006-07
7,9,17,-8,0,0020600060,2006-07
8,11,21,-10,0,0020600060,2006-07
9,12,21,-9,0,0020600060,2006-07
10,16,21,-5,0,0020600060,2006-07
11,16,24,-8,0,0020600060,2006-07
12,21,24,-3,0,0020600060,2006-07
13,21,25,-4,0,0020600060,2006-07
14,24,27,-3,0,0020600060,2006-07
15,26,27,-1,0,0020600060,2006-07
16,29,29,0,0,0020600060,2006-07
17,33,30,3,0,0020600060,2006-07
18,33,32,1,0,0020600060,2006-07
19,35,35,0,0,0020600060,2006-07
20,38,35,3,0,0020600060,2006-07
21,42,37,5,0,0020600060,2006-07
22,42,41,1,0,0020600060,2006-07
23,42,41,1,0,0020600060,2006-07
24,47,42,5,0,0020600060,2006-07
25,47,42,5,0,0020600060,2006-07
26,49,45,4,0,0020600060,2006-07
27,50,47,3,0,0020600060,2006-07
28,54,47,7,0,0020600060,2006-07
29,59,47,12,0,0020600060,2006-07
30,61,51,10,0,0020600060,2006-07
31,63,53,10,0,0020600060,2006-07
32,63,57,6,0,0020600060,2006-07
33,65,62,3,0,0020600060,2006-07
34,65,64,1,0,0020600060,2006-07
35,65,64,1,0,0020600060,2006-07
36,67,67,0,0,0020600060,2006-07
37,69,67,2,0,0020600060,2006-07
38,69,71,-2,0,0020600060,2006-07
39,71,73,-2,0,0020600060,2006-07
40,71,75,-4,0,0020600060,2006-07
41,71,79,-8,0,0020600060,2006-07
42,73,79,-6,0,0020600060,2006-07
43,75,82,-7,0,0020600060,2006-07
44,77,84,-7,0,0020600060,2006-07
45,77,86,-9,0,0020600060,2006-07
46,80,86,-6,0,0020600060,2006-07
47,85,86,-1,0,0020600060,2006-07
48,87,86,1,0,0020600060,2006-07
49,87,88,-1,0,0020600060,2006-07
1,5,0,5,0,0020400703,2004-05
2,5,4,1,0,0020400703,2004-05
3,7,6,1,0,0020400703,2004-05
4,7,9,-2,0,0020400703,2004-05
5,13,9,4,0,0020400703,2004-05
6,17,13,4,0,0020400703,2004-05
7,19,15,4,0,0020400703,2004-05
8,24,15,9,0,0020400703,2004-05
9,26,19,7,0,0020400703,2004-05
10,28,21,7,0,0020400703,2004-05
11,32,23,9,0,0020400703,2004-05
12,34,27,7,0,0020400703,2004-05
13,38,30,8,0,0020400703,2004-05
14,38,35,3,0,0020400703,2004-05
15,40,35,5,0,0020400703,2004-05
16,41,37,4,0,0020400703,2004-05
17,41,39,2,0,0020400703,2004-05
18,41,42,-1,0,0020400703,2004-05
19,43,44,-1,0,0020400703,2004-05
20,44,46,-2,0,0020400703,2004-05
21,46,50,-4,0,0020400703,2004-05
22,46,52,-6,0,0020400703,2004-05
23,50,56,-6,0,0020400703,2004-05
24,53,56,-3,0,0020400703,2004-05
25,55,60,-5,0,0020400703,2004-05
26,59,60,-1,0,0020400703,2004-05
27,59,64,-5,0,0020400703,2004-05
28,64,64,0,0,0020400703,2004-05
29,67,66,1,0,0020400703,2004-05
30,69,66,3,0,0020400703,2004-05
31,71,66,5,0,0020400703,2004-05
32,73,69,4,0,0020400703,2004-05
33,76,70,6,0,0020400703,2004-05
34,79,75,4,0,0020400703,2004-05
35,79,77,2,0,0020400703,2004-05
36,82,78,4,0,0020400703,2004-05
37,85,81,4,0,0020400703,2004-05
38,87,81,6,0,0020400703,2004-05
39,89,87,2,0,0020400703,2004-05
40,89,89,0,0,0020400703,2004-05
41,91,91,0,0,0020400703,2004-05
42,91,93,-2,0,0020400703,2004-05
43,91,93,-2,0,0020400703,2004-05
44,91,95,-4,0,0020400703,2004-05
45,95,97,-2,0,0020400703,2004-05
46,98,100,-2,0,0020400703,2004-05
47,100,104,-4,0,0020400703,2004-05
48,104,108,-4,0,0020400703,2004-05
49,104,108,-4,0,0020400703,2004-05
1,0,3,-3,0,0022100690,2021-22
2,3,5,-2,0,0022100690,2021-22
3,3,5,-2,0,0022100690,2021-22
4,5,5,0,0,0022100690,2021-22
5,8,8,0,0,0022100690,2021-22
6,10,8,2,0,0022100690,2021-22
7,10,10,0,0,0022100690,2021-22
8,10,12,-2,0,0022100690,2021-22
9,12,12,0,0,0022100690,2021-22
10,16,14,2,0,0022100690,2021-22
11,16,17,-1,0,0022100690,2021-22
12,20,24,-4,0,0022100690,2021-22
13,22,26,-4,0,0022100690,2021-22
14,22,26,-4,0,0022100690,2021-22
15,24,28,-4,0,0022100690,2021-22
16,26,28,-2,0,0022100690,2021-22
17,30,28,2,0,0022100690,2021-22
18,34,33,1,0,0022100690,2021-22
19,34,36,-2,0,0022100690,2021-22
20,34,38,-4,0,0022100690,2021-22
21,36,38,-2,0,0022100690,2021-22
22,40,40,0,0,0022100690,2021-22
23,42,43,-1,0,0022100690,2021-22
24,44,45,-1,0,0022100690,2021-22
25,44,47,-3,0,0022100690,2021-22
26,46,49,-3,0,0022100690,2021-22
27,49,53,-4,0,0022100690,2021-22
28,49,53,-4,0,0022100690,2021-22
29,51,53,-2,0,0022100690,2021-22
30,54,55,-1,0,0022100690,2021-22
31,54,58,-4,0,0022100690,2021-22
32,57,60,-3,0,0022100690,2021-22
33,60,60,0,0,0022100690,2021-22
34,60,60,0,0,0022100690,2021-22
35,65,64,1,0,0022100690,2021-22
36,69,66,3,0,0022100690,2021-22
37,72,70,2,0,0022100690,2021-22
38,74,70,4,0,0022100690,2021-22
39,74,74,0,0,0022100690,2021-22
40,74,76,-2,0,0022100690,2021-22
41,76,79,-3,0,0022100690,2021-22
42,79,80,-1,0,0022100690,2021-22
43,79,83,-4,0,0022100690,2021-22
44,79,85,-6,0,0022100690,2021-22
45,83,88,-5,0,0022100690,2021-22
46,85,92,-7,0,0022100690,2021-22
47,90,92,-2,0,0022100690,2021-22
48,90,94,-4,0,0022100690,2021-22
49,90,94,-4,0,0022100690,2021-22
1,3,2,1,0,0020100314,2001-02
2,3,2,1,0,0020100314,2001-02
3,3,2,1,0,0020100314,2001-02
4,7,7,0,0,0020100314,2001-02
5,7,11,-4,0,0020100314,2001-02
6,7,13,-6,0,0020100314,2001-02
7,9,18,-9,0,0020100314,2001-02
8,13,22,-9,0,0020100314,2001-02
9,15,24,-9,0,0020100314,2001-02
10,17,24,-7,0,0020100314,2001-02
11,19,26,-7,0,0020100314,2001-02
12,21,27,-6,0,0020100314,2001-02
13,21,27,-6,0,0020100314,2001-02
14,21,29,-8,0,0020100314,2001-02
15,23,31,-8,0,0020100314,2001-02
16,25,31,-6,0,0020100314,2001-02
17,29,31,-2,0,0020100314,2001-02
18,29,32,-3,0,0020100314,2001-02
19,29,36,-7,0,0020100314,2001-02
20,29,40,-11,0,0020100314,2001-02
21,32,44,-12,0,0020100314,2001-02
22,34,46,-12,0,0020100314,2001-02
23,36,48,-12,0,0020100314,2001-02
24,40,53,-13,0,0020100314,2001-02
25,40,55,-15,0,0020100314,2001-02
26,42,58,-16,0,0020100314,2001-02
27,42,60,-18,0,0020100314,2001-02
28,42,60,-18,0,0020100314,2001-02
29,46,62,-16,0,0020100314,2001-02
30,49,64,-15,0,0020100314,2001-02
31,53,68,-15,0,0020100314,2001-02
32,56,70,-14,0,0020100314,2001-02
33,58,72,-14,0,0020100314,2001-02
34,60,77,-17,0,0020100314,2001-02
35,62,77,-15,0,0020100314,2001-02
36,62,79,-17,0,0020100314,2001-02
37,65,79,-14,0,0020100314,2001-02
38,67,79,-12,0,0020100314,2001-02
39,67,81,-14,0,0020100314,2001-02
40,67,84,-17,0,0020100314,2001-02
41,69,84,-15,0,0020100314,2001-02
42,71,86,-15,0,0020100314,2001-02
43,71,90,-19,0,0020100314,2001-02
44,74,90,-16,0,0020100314,2001-02
45,77,92,-15,0,0020100314,2001-02
46,77,92,-15,0,0020100314,2001-02
47,79,94,-15,0,0020100314,2001-02
48,80,96,-16,0,0020100314,2001-02
49,80,96,-16,0,0020100314,2001-02
1,2,0,2,1,0020100232,2001-02
2,4,2,2,1,0020100232,2001-02
3,7,2,5,1,0020100232,2001-02
4,13,2,11,1,0020100232,2001-02
5,17,2,15,1,0020100232,2001-02
6,19,4,15,1,0020100232,2001-02
7,21,6,15,1,0020100232,2001-02
8,23,11,12,1,0020100232,2001-02
9,25,13,12,1,0020100232,2001-02
10,27,16,11,1,0020100232,2001-02
11,30,16,14,1,0020100232,2001-02
12,32,18,14,1,0020100232,2001-02
13,32,20,12,1,0020100232,2001-02
14,32,22,10,1,0020100232,2001-02
15,32,22,10,1,0020100232,2001-02
16,34,22,12,1,0020100232,2001-02
17,34,24,10,1,0020100232,2001-02
18,38,24,14,1,0020100232,2001-02
19,38,24,14,1,0020100232,2001-02
20,38,25,13,1,0020100232,2001-02
21,38,25,13,1,0020100232,2001-02
22,38,28,10,1,0020100232,2001-02
23,38,32,6,1,0020100232,2001-02
24,40,35,5,1,0020100232,2001-02
25,42,35,7,1,0020100232,2001-02
26,44,35,9,1,0020100232,2001-02
27,44,35,9,1,0020100232,2001-02
28,46,37,9,1,0020100232,2001-02
29,46,39,7,1,0020100232,2001-02
30,48,39,9,1,0020100232,2001-02
31,50,42,8,1,0020100232,2001-02
32,51,42,9,1,0020100232,2001-02
33,51,44,7,1,0020100232,2001-02
34,53,46,7,1,0020100232,2001-02
35,53,48,5,1,0020100232,2001-02
36,57,53,4,1,0020100232,2001-02
37,60,53,7,1,0020100232,2001-02
38,62,59,3,1,0020100232,2001-02
39,62,61,1,1,0020100232,2001-02
40,64,61,3,1,0020100232,2001-02
41,67,63,4,1,0020100232,2001-02
42,69,63,6,1,0020100232,2001-02
43,71,65,6,1,0020100232,2001-02
44,74,69,5,1,0020100232,2001-02
45,76,69,7,1,0020100232,2001-02
46,78,71,7,1,0020100232,2001-02
47,83,71,12,1,0020100232,2001-02
48,85,75,10,1,0020100232,2001-02
49,85,75,10,1,0020100232,2001-02
1,0,3,-3,1,0020400624,2004-05
2,0,5,-5,1,0020400624,2004-05
3,4,5,-1,1,0020400624,2004-05
4,4,5,-1,1,0020400624,2004-05
5,9,5,4,1,0020400624,2004-05
6,13,7,6,1,0020400624,2004-05
7,13,9,4,1,0020400624,2004-05
8,13,13,0,1,0020400624,2004-05
9,17,13,4,1,0020400624,2004-05
10,19,15,4,1,0020400624,2004-05
11,21,18,3,1,0020400624,2004-05
12,24,20,4,1,0020400624,2004-05
13,30,22,8,1,0020400624,2004-05
14,32,22,10,1,0020400624,2004-05
15,33,24,9,1,0020400624,2004-05
16,34,25,9,1,0020400624,2004-05
17,36,25,11,1,0020400624,2004-05
18,39,25,14,1,0020400624,2004-05
19,39,30,9,1,0020400624,2004-05
20,41,32,9,1,0020400624,2004-05
21,43,33,10,1,0020400624,2004-05
22,47,35,12,1,0020400624,2004-05
23,47,35,12,1,0020400624,2004-05
24,47,40,7,1,0020400624,2004-05
25,49,40,9,1,0020400624,2004-05
26,52,42,10,1,0020400624,2004-05
27,52,44,8,1,0020400624,2004-05
28,57,46,11,1,0020400624,2004-05
29,59,48,11,1,0020400624,2004-05
30,59,51,8,1,0020400624,2004-05
31,61,51,10,1,0020400624,2004-05
32,61,51,10,1,0020400624,2004-05
33,63,51,12,1,0020400624,2004-05
34,66,54,12,1,0020400624,2004-05
35,68,57,11,1,0020400624,2004-05
36,70,57,13,1,0020400624,2004-05
37,70,62,8,1,0020400624,2004-05
38,72,62,10,1,0020400624,2004-05
39,72,64,8,1,0020400624,2004-05
40,75,64,11,1,0020400624,2004-05
41,78,66,12,1,0020400624,2004-05
42,79,67,12,1,0020400624,2004-05
43,79,67,12,1,0020400624,2004-05
44,81,69,12,1,0020400624,2004-05
45,85,71,14,1,0020400624,2004-05
46,87,71,16,1,0020400624,2004-05
47,88,71,17,1,0020400624,2004-05
48,88,76,12,1,0020400624,2004-05
49,88,76,12,1,0020400624,2004-05
1,0,4,-4,1,0029800325,1998-99
2,2,6,-4,1,0029800325,1998-99
3,2,10,-8,1,0029800325,1998-99
4,4,12,-8,1,0029800325,1998-99
5,4,16,-12,1,0029800325,1998-99
6,4,18,-14,1,0029800325,1998-99
7,6,20,-14,1,0029800325,1998-99
8,7,20,-13,1,0029800325,1998-99
9,12,20,-8,1,0029800325,1998-99
10,13,22,-9,1,0029800325,1998-99
11,14,22,-8,1,0029800325,1998-99
12,17,24,-7,1,0029800325,1998-99
13,17,24,-7,1,0029800325,1998-99
14,22,24,-2,1,0029800325,1998-99
15,22,26,-4,1,0029800325,1998-99
16,24,26,-2,1,0029800325,1998-99
17,26,26,0,1,0029800325,1998-99
18,29,28,1,1,0029800325,1998-99
19,32,28,4,1,0029800325,1998-99
20,35,30,5,1,0029800325,1998-99
21,35,32,3,1,0029800325,1998-99
22,37,34,3,1,0029800325,1998-99
23,37,36,1,1,0029800325,1998-99
24,41,38,3,1,0029800325,1998-99
25,41,38,3,1,0029800325,1998-99
26,41,40,1,1,0029800325,1998-99
27,43,40,3,1,0029800325,1998-99
28,43,42,1,1,0029800325,1998-99
29,45,44,1,1,0029800325,1998-99
30,47,45,2,1,0029800325,1998-99
31,48,48,0,1,0029800325,1998-99
32,49,50,-1,1,0029800325,1998-99
33,52,52,0,1,0029800325,1998-99
34,54,54,0,1,0029800325,1998-99
35,54,56,-2,1,0029800325,1998-99
36,54,56,-2,1,0029800325,1998-99
37,56,56,0,1,0029800325,1998-99
38,58,58,0,1,0029800325,1998-99
39,59,60,-1,1,0029800325,1998-99
40,63,62,1,1,0029800325,1998-99
41,65,62,3,1,0029800325,1998-99
42,65,65,0,1,0029800325,1998-99
43,65,65,0,1,0029800325,1998-99
44,69,68,1,1,0029800325,1998-99
45,71,68,3,1,0029800325,1998-99
46,73,70,3,1,0029800325,1998-99
47,75,70,5,1,0029800325,1998-99
48,82,78,4,1,0029800325,1998-99
49,82,78,4,1,0029800325,1998-99
1,0,0,0,1,0021100866,2011-12
2,3,0,3,1,0021100866,2011-12
3,5,2,3,1,0021100866,2011-12
4,5,7,-2,1,0021100866,2011-12
5,7,10,-3,1,0021100866,2011-12
6,10,10,0,1,0021100866,2011-12
7,13,12,1,1,0021100866,2011-12
8,13,18,-5,1,0021100866,2011-12
9,18,18,0,1,0021100866,2011-12
10,20,18,2,1,0021100866,2011-12
11,22,18,4,1,0021100866,2011-12
12,24,21,3,1,0021100866,2011-12
13,30,26,4,1,0021100866,2011-12
14,33,28,5,1,0021100866,2011-12
15,35,28,7,1,0021100866,2011-12
16,35,31,4,1,0021100866,2011-12
17,37,31,6,1,0021100866,2011-12
18,39,31,8,1,0021100866,2011-12
19,39,31,8,1,0021100866,2011-12
20,44,31,13,1,0021100866,2011-12
21,44,35,9,1,0021100866,2011-12
22,46,35,11,1,0021100866,2011-12
23,48,40,8,1,0021100866,2011-12
24,48,43,5,1,0021100866,2011-12
25,50,45,5,1,0021100866,2011-12
26,52,45,7,1,0021100866,2011-12
27,54,45,9,1,0021100866,2011-12
28,58,45,13,1,0021100866,2011-12
29,58,49,9,1,0021100866,2011-12
30,63,51,12,1,0021100866,2011-12
31,65,51,14,1,0021100866,2011-12
32,69,51,18,1,0021100866,2011-12
33,71,54,17,1,0021100866,2011-12
34,73,59,14,1,0021100866,2011-12
35,73,59,14,1,0021100866,2011-12
36,75,59,16,1,0021100866,2011-12
37,77,59,18,1,0021100866,2011-12
38,80,61,19,1,0021100866,2011-12
39,84,63,21,1,0021100866,2011-12
40,86,63,23,1,0021100866,2011-12
41,89,66,23,1,0021100866,2011-12
42,89,72,17,1,0021100866,2011-12
43,89,72,17,1,0021100866,2011-12
44,89,72,17,1,0021100866,2011-12
45,90,74,16,1,0021100866,2011-12
46,90,79,11,1,0021100866,2011-12
47,95,79,16,1,0021100866,2011-12
48,98,84,14,1,0021100866,2011-12
49,98,84,14,1,0021100866,2011-12
1,0,4,-4,1,0029700857,1997-98
2,2,6,-4,1,0029700857,1997-98
3,4,11,-7,1,0029700857,1997-98
4,9,13,-4,1,0029700857,1997-98
5,9,17,-8,1,0029700857,1997-98
6,11,22,-11,1,0029700857,1997-98
7,15,22,-7,1,0029700857,1997-98
8,17,24,-7,1,0029700857,1997-98
9,19,27,-8,1,0029700857,1997-98
10,23,27,-4,1,0029700857,1997-98
11,27,30,-3,1,0029700857,1997-98
12,31,34,-3,1,0029700857,1997-98
13,33,38,-5,1,0029700857,1997-98
14,35,40,-5,1,0029700857,1997-98
15,36,40,-4,1,0029700857,1997-98
16,38,40,-2,1,0029700857,1997-98
17,38,44,-6,1,0029700857,1997-98
18,40,46,-6,1,0029700857,1997-98
19,40,46,-6,1,0029700857,1997-98
20,42,50,-8,1,0029700857,1997-98
21,44,50,-6,1,0029700857,1997-98
22,46,50,-4,1,0029700857,1997-98
23,50,51,-1,1,0029700857,1997-98
24,54,55,-1,1,0029700857,1997-98
25,56,58,-2,1,0029700857,1997-98
26,62,58,4,1,0029700857,1997-98
27,64,60,4,1,0029700857,1997-98
28,68,64,4,1,0029700857,1997-98
29,71,66,5,1,0029700857,1997-98
30,71,66,5,1,0029700857,1997-98
31,74,68,6,1,0029700857,1997-98
32,77,71,6,1,0029700857,1997-98
33,79,73,6,1,0029700857,1997-98
34,83,73,10,1,0029700857,1997-98
35,85,75,10,1,0029700857,1997-98
36,89,79,10,1,0029700857,1997-98
37,92,79,13,1,0029700857,1997-98
38,92,81,11,1,0029700857,1997-98
39,92,85,7,1,0029700857,1997-98
40,94,87,7,1,0029700857,1997-98
41,96,87,9,1,0029700857,1997-98
42,100,91,9,1,0029700857,1997-98
43,102,93,9,1,0029700857,1997-98
44,104,98,6,1,0029700857,1997-98
45,106,100,6,1,0029700857,1997-98
46,111,104,7,1,0029700857,1997-98
47,115,110,5,1,0029700857,1997-98
48,122,115,7,1,0029700857,1997-98
49,122,115,7,1,0029700857,1997-98
1,2,4,-2,0,0020400201,2004-05
2,2,6,-4,0,0020400201,2004-05
3,6,8,-2,0,0020400201,2004-05
4,8,13,-5,0,0020400201,2004-05
5,8,13,-5,0,0020400201,2004-05
6,10,17,-7,0,0020400201,2004-05
7,10,19,-9,0,0020400201,2004-05
8,10,21,-11,0,0020400201,2004-05
9,12,24,-12,0,0020400201,2004-05
10,17,26,-9,0,0020400201,2004-05
11,17,30,-13,0,0020400201,2004-05
12,21,32,-11,0,0020400201,2004-05
13,21,34,-13,0,0020400201,2004-05
14,23,37,-14,0,0020400201,2004-05
15,25,37,-12,0,0020400201,2004-05
16,25,38,-13,0,0020400201,2004-05
17,30,40,-10,0,0020400201,2004-05
18,32,42,-10,0,0020400201,2004-05
19,32,42,-10,0,0020400201,2004-05
20,33,44,-11,0,0020400201,2004-05
21,35,46,-11,0,0020400201,2004-05
22,37,48,-11,0,0020400201,2004-05
23,39,50,-11,0,0020400201,2004-05
24,41,52,-11,0,0020400201,2004-05
25,42,52,-10,0,0020400201,2004-05
26,47,52,-5,0,0020400201,2004-05
27,47,52,-5,0,0020400201,2004-05
28,48,54,-6,0,0020400201,2004-05
29,52,56,-4,0,0020400201,2004-05
30,56,58,-2,0,0020400201,2004-05
31,58,60,-2,0,0020400201,2004-05
32,60,62,-2,0,0020400201,2004-05
33,62,64,-2,0,0020400201,2004-05
34,64,68,-4,0,0020400201,2004-05
35,66,70,-4,0,0020400201,2004-05
36,68,70,-2,0,0020400201,2004-05
37,68,73,-5,0,0020400201,2004-05
38,70,73,-3,0,0020400201,2004-05
39,72,75,-3,0,0020400201,2004-05
40,72,79,-7,0,0020400201,2004-05
41,72,81,-9,0,0020400201,2004-05
42,74,83,-9,0,0020400201,2004-05
43,74,85,-11,0,0020400201,2004-05
44,74,85,-11,0,0020400201,2004-05
45,76,87,-11,0,0020400201,2004-05
46,76,89,-13,0,0020400201,2004-05
47,78,92,-14,0,0020400201,2004-05
48,82,94,-12,0,0020400201,2004-05
49,82,94,-12,0,0020400201,2004-05
1,3,0,3,1,0021400028,2014-15
2,3,2,1,1,0021400028,2014-15
3,5,8,-3,1,0021400028,2014-15
4,5,8,-3,1,0021400028,2014-15
5,8,8,0,1,0021400028,2014-15
6,12,8,4,1,0021400028,2014-15
7,12,9,3,1,0021400028,2014-15
8,14,9,5,1,0021400028,2014-15
9,17,11,6,1,0021400028,2014-15
10,17,11,6,1,0021400028,2014-15
11,19,11,8,1,0021400028,2014-15
12,23,15,8,1,0021400028,2014-15
13,26,15,11,1,0021400028,2014-15
14,26,15,11,1,0021400028,2014-15
15,28,18,10,1,0021400028,2014-15
16,28,18,10,1,0021400028,2014-15
17,30,18,12,1,0021400028,2014-15
18,32,18,14,1,0021400028,2014-15
19,32,18,14,1,0021400028,2014-15
20,32,22,10,1,0021400028,2014-15
21,32,25,7,1,0021400028,2014-15
22,34,27,7,1,0021400028,2014-15
23,34,28,6,1,0021400028,2014-15
24,36,30,6,1,0021400028,2014-15
25,38,30,8,1,0021400028,2014-15
26,40,30,10,1,0021400028,2014-15
27,42,32,10,1,0021400028,2014-15
28,42,34,8,1,0021400028,2014-15
29,44,34,10,1,0021400028,2014-15
30,46,34,12,1,0021400028,2014-15
31,46,36,10,1,0021400028,2014-15
32,46,38,8,1,0021400028,2014-15
33,46,40,6,1,0021400028,2014-15
34,49,42,7,1,0021400028,2014-15
35,49,44,5,1,0021400028,2014-15
36,51,46,5,1,0021400028,2014-15
37,54,46,8,1,0021400028,2014-15
38,54,48,6,1,0021400028,2014-15
39,56,53,3,1,0021400028,2014-15
40,58,55,3,1,0021400028,2014-15
41,58,55,3,1,0021400028,2014-15
42,58,57,1,1,0021400028,2014-15
43,60,59,1,1,0021400028,2014-15
44,60,62,-2,1,0021400028,2014-15
45,62,65,-3,1,0021400028,2014-15
46,66,68,-2,1,0021400028,2014-15
47,68,69,-1,1,0021400028,2014-15
48,71,69,2,1,0021400028,2014-15
49,71,69,2,1,0021400028,2014-15
1,0,2,-2,1,0022100621,2021-22
2,0,2,-2,1,0022100621,2021-22
3,0,6,-6,1,0022100621,2021-22
4,2,10,-8,1,0022100621,2021-22
5,4,13,-9,1,0022100621,2021-22
6,6,13,-7,1,0022100621,2021-22
7,9,16,-7,1,0022100621,2021-22
8,11,18,-7,1,0022100621,2021-22
9,13,20,-7,1,0022100621,2021-22
10,15,20,-5,1,0022100621,2021-22
11,19,22,-3,1,0022100621,2021-22
12,21,27,-6,1,0022100621,2021-22
13,24,30,-6,1,0022100621,2021-22
14,30,33,-3,1,0022100621,2021-22
15,32,33,-1,1,0022100621,2021-22
16,35,35,0,1,0022100621,2021-22
17,37,37,0,1,0022100621,2021-22
18,39,38,1,1,0022100621,2021-22
19,39,41,-2,1,0022100621,2021-22
20,44,44,0,1,0022100621,2021-22
21,49,47,2,1,0022100621,2021-22
22,52,47,5,1,0022100621,2021-22
23,52,49,3,1,0022100621,2021-22
24,56,51,5,1,0022100621,2021-22
25,61,51,10,1,0022100621,2021-22
26,64,51,13,1,0022100621,2021-22
27,67,51,16,1,0022100621,2021-22
28,70,51,19,1,0022100621,2021-22
29,72,53,19,1,0022100621,2021-22
30,75,55,20,1,0022100621,2021-22
31,77,57,20,1,0022100621,2021-22
32,79,59,20,1,0022100621,2021-22
33,79,64,15,1,0022100621,2021-22
34,81,65,16,1,0022100621,2021-22
35,84,65,19,1,0022100621,2021-22
36,86,67,19,1,0022100621,2021-22
37,86,67,19,1,0022100621,2021-22
38,88,70,18,1,0022100621,2021-22
39,88,75,13,1,0022100621,2021-22
40,92,78,14,1,0022100621,2021-22
41,92,78,14,1,0022100621,2021-22
42,96,78,18,1,0022100621,2021-22
43,96,83,13,1,0022100621,2021-22
44,102,83,19,1,0022100621,2021-22
45,104,88,16,1,0022100621,2021-22
46,109,88,21,1,0022100621,2021-22
47,112,91,21,1,0022100621,2021-22
48,115,91,24,1,0022100621,2021-22
49,115,91,24,1,0022100621,2021-22
1,2,2,0,1,0029600906,1996-97
2,4,6,-2,1,0029600906,1996-97
3,7,6,1,1,0029600906,1996-97
4,7,11,-4,1,0029600906,1996-97
5,9,13,-4,1,0029600906,1996-97
6,11,15,-4,1,0029600906,1996-97
7,13,15,-2,1,0029600906,1996-97
8,15,17,-2,1,0029600906,1996-97
9,17,17,0,1,0029600906,1996-97
10,17,22,-5,1,0029600906,1996-97
11,22,22,0,1,0029600906,1996-97
12,27,24,3,1,0029600906,1996-97
13,29,24,5,1,0029600906,1996-97
14,31,26,5,1,0029600906,1996-97
15,33,30,3,1,0029600906,1996-97
16,37,30,7,1,0029600906,1996-97
17,37,30,7,1,0029600906,1996-97
18,37,32,5,1,0029600906,1996-97
19,41,32,9,1,0029600906,1996-97
20,43,36,7,1,0029600906,1996-97
21,45,41,4,1,0029600906,1996-97
22,47,41,6,1,0029600906,1996-97
23,49,43,6,1,0029600906,1996-97
24,51,49,2,1,0029600906,1996-97
25,53,53,0,1,0029600906,1996-97
26,56,57,-1,1,0029600906,1996-97
27,56,59,-3,1,0029600906,1996-97
28,58,59,-1,1,0029600906,1996-97
29,60,61,-1,1,0029600906,1996-97
30,62,61,1,1,0029600906,1996-97
31,67,61,6,1,0029600906,1996-97
32,69,63,6,1,0029600906,1996-97
33,71,66,5,1,0029600906,1996-97
34,73,71,2,1,0029600906,1996-97
35,75,71,4,1,0029600906,1996-97
36,77,74,3,1,0029600906,1996-97
37,79,74,5,1,0029600906,1996-97
38,82,77,5,1,0029600906,1996-97
39,84,77,7,1,0029600906,1996-97
40,88,77,11,1,0029600906,1996-97
41,88,77,11,1,0029600906,1996-97
42,90,79,11,1,0029600906,1996-97
43,92,81,11,1,0029600906,1996-97
44,97,81,16,1,0029600906,1996-97
45,99,83,16,1,0029600906,1996-97
46,103,85,18,1,0029600906,1996-97
47,106,89,17,1,0029600906,1996-97
48,108,92,16,1,0029600906,1996-97
49,108,92,16,1,0029600906,1996-97
1,2,4,-2,0,0021000898,2010-11
2,6,4,2,0,0021000898,2010-11
3,6,6,0,0,0021000898,2010-11
4,11,10,1,0,0021000898,2010-11
5,12,12,0,0,0021000898,2010-11
6,14,16,-2,0,0021000898,2010-11
7,14,20,-6,0,0021000898,2010-11
8,14,22,-8,0,0021000898,2010-11
9,16,24,-8,0,0021000898,2010-11
10,20,26,-6,0,0021000898,2010-11
11,22,30,-8,0,0021000898,2010-11
12,30,32,-2,0,0021000898,2010-11
13,30,36,-6,0,0021000898,2010-11
14,33,38,-5,0,0021000898,2010-11
15,33,42,-9,0,0021000898,2010-11
16,35,46,-11,0,0021000898,2010-11
17,35,46,-11,0,0021000898,2010-11
18,38,46,-8,0,0021000898,2010-11
19,42,46,-4,0,0021000898,2010-11
20,42,48,-6,0,0021000898,2010-11
21,45,53,-8,0,0021000898,2010-11
22,49,55,-6,0,0021000898,2010-11
23,52,57,-5,0,0021000898,2010-11
24,52,59,-7,0,0021000898,2010-11
25,54,63,-9,0,0021000898,2010-11
26,58,63,-5,0,0021000898,2010-11
27,58,63,-5,0,0021000898,2010-11
28,58,65,-7,0,0021000898,2010-11
29,60,69,-9,0,0021000898,2010-11
30,60,71,-11,0,0021000898,2010-11
31,60,73,-13,0,0021000898,2010-11
32,60,75,-15,0,0021000898,2010-11
33,62,78,-16,0,0021000898,2010-11
34,64,78,-14,0,0021000898,2010-11
35,66,82,-16,0,0021000898,2010-11
36,67,83,-16,0,0021000898,2010-11
37,67,83,-16,0,0021000898,2010-11
38,67,87,-20,0,0021000898,2010-11
39,67,92,-25,0,0021000898,2010-11
40,70,92,-22,0,0021000898,2010-11
41,73,94,-21,0,0021000898,2010-11
42,78,97,-19,0,0021000898,2010-11
43,82,99,-17,0,0021000898,2010-11
44,85,101,-16,0,0021000898,2010-11
45,88,107,-19,0,0021000898,2010-11
46,91,107,-16,0,0021000898,2010-11
47,91,109,-18,0,0021000898,2010-11
48,93,109,-16,0,0021000898,2010-11
49,93,109,-16,0,0021000898,2010-11
1,2,3,-1,0,0020300135,2003-04
2,4,3,1,0,0020300135,2003-04
3,11,3,8,0,0020300135,2003-04
4,13,3,10,0,0020300135,2003-04
5,15,7,8,0,0020300135,2003-04
6,17,9,8,0,0020300135,2003-04
7,17,10,7,0,0020300135,2003-04
8,17,12,5,0,0020300135,2003-04
9,22,14,8,0,0020300135,2003-04
10,22,16,6,0,0020300135,2003-04
11,25,16,9,0,0020300135,2003-04
12,28,19,9,0,0020300135,2003-04
13,31,19,12,0,0020300135,2003-04
14,33,24,9,0,0020300135,2003-04
15,37,24,13,0,0020300135,2003-04
16,39,29,10,0,0020300135,2003-04
17,43,31,12,0,0020300135,2003-04
18,45,31,14,0,0020300135,2003-04
19,45,34,11,0,0020300135,2003-04
20,45,36,9,0,0020300135,2003-04
21,47,40,7,0,0020300135,2003-04
22,49,45,4,0,0020300135,2003-04
23,53,47,6,0,0020300135,2003-04
24,55,50,5,0,0020300135,2003-04
25,55,52,3,0,0020300135,2003-04
26,57,54,3,0,0020300135,2003-04
27,59,54,5,0,0020300135,2003-04
28,59,59,0,0,0020300135,2003-04
29,59,62,-3,0,0020300135,2003-04
30,61,62,-1,0,0020300135,2003-04
31,63,64,-1,0,0020300135,2003-04
32,63,68,-5,0,0020300135,2003-04
33,65,71,-6,0,0020300135,2003-04
34,69,72,-3,0,0020300135,2003-04
35,69,72,-3,0,0020300135,2003-04
36,73,75,-2,0,0020300135,2003-04
37,73,78,-5,0,0020300135,2003-04
38,74,80,-6,0,0020300135,2003-04
39,78,80,-2,0,0020300135,2003-04
40,78,82,-4,0,0020300135,2003-04
41,80,84,-4,0,0020300135,2003-04
42,82,86,-4,0,0020300135,2003-04
43,85,86,-1,0,0020300135,2003-04
44,87,88,-1,0,0020300135,2003-04
45,87,88,-1,0,0020300135,2003-04
46,89,90,-1,0,0020300135,2003-04
47,91,92,-1,0,0020300135,2003-04
48,92,95,-3,0,0020300135,2003-04
49,92,95,-3,0,0020300135,2003-04
1,4,0,4,1,0021600156,2016-17
2,8,0,8,1,0021600156,2016-17
3,10,0,10,1,0021600156,2016-17
4,13,2,11,1,0021600156,2016-17
5,13,2,11,1,0021600156,2016-17
6,17,4,13,1,0021600156,2016-17
7,22,7,15,1,0021600156,2016-17
8,24,9,15,1,0021600156,2016-17
9,28,9,19,1,0021600156,2016-17
10,30,9,21,1,0021600156,2016-17
11,33,14,19,1,0021600156,2016-17
12,35,14,21,1,0021600156,2016-17
13,37,14,23,1,0021600156,2016-17
14,39,16,23,1,0021600156,2016-17
15,39,20,19,1,0021600156,2016-17
16,42,20,22,1,0021600156,2016-17
17,42,24,18,1,0021600156,2016-17
18,44,28,16,1,0021600156,2016-17
19,46,28,18,1,0021600156,2016-17
20,48,28,20,1,0021600156,2016-17
21,48,30,18,1,0021600156,2016-17
22,49,33,16,1,0021600156,2016-17
23,54,33,21,1,0021600156,2016-17
24,56,37,19,1,0021600156,2016-17
25,58,37,21,1,0021600156,2016-17
26,60,37,23,1,0021600156,2016-17
27,62,40,22,1,0021600156,2016-17
28,66,42,24,1,0021600156,2016-17
29,68,45,23,1,0021600156,2016-17
30,70,49,21,1,0021600156,2016-17
31,72,53,19,1,0021600156,2016-17
32,74,56,18,1,0021600156,2016-17
33,76,56,20,1,0021600156,2016-17
34,76,56,20,1,0021600156,2016-17
35,78,58,20,1,0021600156,2016-17
36,83,63,20,1,0021600156,2016-17
37,89,65,24,1,0021600156,2016-17
38,92,67,25,1,0021600156,2016-17
39,94,72,22,1,0021600156,2016-17
40,96,72,24,1,0021600156,2016-17
41,99,77,22,1,0021600156,2016-17
42,101,79,22,1,0021600156,2016-17
43,104,82,22,1,0021600156,2016-17
44,108,85,23,1,0021600156,2016-17
45,108,88,20,1,0021600156,2016-17
46,111,88,23,1,0021600156,2016-17
47,111,88,23,1,0021600156,2016-17
48,113,88,25,1,0021600156,2016-17
49,113,88,25,1,0021600156,2016-17
1,3,0,3,1,0022100682,2021-22
2,5,0,5,1,0022100682,2021-22
3,5,3,2,1,0022100682,2021-22
4,7,3,4,1,0022100682,2021-22
5,9,8,1,1,0022100682,2021-22
6,11,13,-2,1,0022100682,2021-22
7,13,15,-2,1,0022100682,2021-22
8,18,17,1,1,0022100682,2021-22
9,20,17,3,1,0022100682,2021-22
10,20,19,1,1,0022100682,2021-22
11,20,23,-3,1,0022100682,2021-22
12,22,26,-4,1,0022100682,2021-22
13,26,26,0,1,0022100682,2021-22
14,26,26,0,1,0022100682,2021-22
15,28,26,2,1,0022100682,2021-22
16,32,28,4,1,0022100682,2021-22
17,32,33,-1,1,0022100682,2021-22
18,32,38,-6,1,0022100682,2021-22
19,32,40,-8,1,0022100682,2021-22
20,34,42,-8,1,0022100682,2021-22
21,40,42,-2,1,0022100682,2021-22
22,42,45,-3,1,0022100682,2021-22
23,45,48,-3,1,0022100682,2021-22
24,45,50,-5,1,0022100682,2021-22
25,45,55,-10,1,0022100682,2021-22
26,50,59,-9,1,0022100682,2021-22
27,55,61,-6,1,0022100682,2021-22
28,55,63,-8,1,0022100682,2021-22
29,59,66,-7,1,0022100682,2021-22
30,63,68,-5,1,0022100682,2021-22
31,67,68,-1,1,0022100682,2021-22
32,70,68,2,1,0022100682,2021-22
33,72,72,0,1,0022100682,2021-22
34,72,77,-5,1,0022100682,2021-22
35,74,77,-3,1,0022100682,2021-22
36,74,82,-8,1,0022100682,2021-22
37,77,84,-7,1,0022100682,2021-22
38,77,86,-9,1,0022100682,2021-22
39,80,87,-7,1,0022100682,2021-22
40,85,92,-7,1,0022100682,2021-22
41,87,95,-8,1,0022100682,2021-22
42,92,95,-3,1,0022100682,2021-22
43,94,95,-1,1,0022100682,2021-22
44,96,97,-1,1,0022100682,2021-22
45,99,99,0,1,0022100682,2021-22
46,102,99,3,1,0022100682,2021-22
47,104,99,5,1,0022100682,2021-22
48,109,101,8,1,0022100682,2021-22
49,109,101,8,1,0022100682,2021-22
1,2,0,2,1,0021900348,2019-20
2,2,6,-4,1,0021900348,2019-20
3,4,8,-4,1,0021900348,2019-20
4,4,12,-8,1,0021900348,2019-20
5,6,12,-6,1,0021900348,2019-20
6,6,16,-10,1,0021900348,2019-20
7,11,21,-10,1,0021900348,2019-20
8,13,22,-9,1,0021900348,2019-20
9,15,22,-7,1,0021900348,2019-20
10,18,27,-9,1,0021900348,2019-20
11,20,29,-9,1,0021900348,2019-20
12,25,29,-4,1,0021900348,2019-20
13,28,29,-1,1,0021900348,2019-20
14,29,34,-5,1,0021900348,2019-20
15,29,34,-5,1,0021900348,2019-20
16,31,36,-5,1,0021900348,2019-20
17,32,36,-4,1,0021900348,2019-20
18,35,37,-2,1,0021900348,2019-20
19,37,39,-2,1,0021900348,2019-20
20,37,42,-5,1,0021900348,2019-20
21,39,45,-6,1,0021900348,2019-20
22,43,47,-4,1,0021900348,2019-20
23,47,49,-2,1,0021900348,2019-20
24,47,53,-6,1,0021900348,2019-20
25,49,53,-4,1,0021900348,2019-20
26,53,53,0,1,0021900348,2019-20
27,57,55,2,1,0021900348,2019-20
28,60,57,3,1,0021900348,2019-20
29,64,59,5,1,0021900348,2019-20
30,64,61,3,1,0021900348,2019-20
31,67,65,2,1,0021900348,2019-20
32,73,65,8,1,0021900348,2019-20
33,73,68,5,1,0021900348,2019-20
34,74,71,3,1,0021900348,2019-20
35,79,73,6,1,0021900348,2019-20
36,81,74,7,1,0021900348,2019-20
37,83,74,9,1,0021900348,2019-20
38,88,76,12,1,0021900348,2019-20
39,90,81,9,1,0021900348,2019-20
40,92,87,5,1,0021900348,2019-20
41,94,89,5,1,0021900348,2019-20
42,94,91,3,1,0021900348,2019-20
43,96,93,3,1,0021900348,2019-20
44,99,97,2,1,0021900348,2019-20
45,99,97,2,1,0021900348,2019-20
46,101,99,2,1,0021900348,2019-20
47,101,103,-2,1,0021900348,2019-20
48,103,103,0,1,0021900348,2019-20
49,105,103,2,1,0021900348,2019-20
1,0,2,-2,0,0020900925,2009-10
2,0,6,-6,0,0020900925,2009-10
3,7,8,-1,0,0020900925,2009-10
4,10,10,0,0,0020900925,2009-10
5,10,12,-2,0,0020900925,2009-10
6,10,15,-5,0,0020900925,2009-10
7,16,15,1,0,0020900925,2009-10
8,16,18,-2,0,0020900925,2009-10
9,19,20,-1,0,0020900925,2009-10
10,19,22,-3,0,0020900925,2009-10
11,19,24,-5,0,0020900925,2009-10
12,19,24,-5,0,0020900925,2009-10
13,21,27,-6,0,0020900925,2009-10
14,27,27,0,0,0020900925,2009-10
15,30,29,1,0,0020900925,2009-10
16,36,32,4,0,0020900925,2009-10
17,39,36,3,0,0020900925,2009-10
18,42,37,5,0,0020900925,2009-10
19,46,39,7,0,0020900925,2009-10
20,46,44,2,0,0020900925,2009-10
21,50,46,4,0,0020900925,2009-10
22,50,47,3,0,0020900925,2009-10
23,51,49,2,0,0020900925,2009-10
24,54,53,1,0,0020900925,2009-10
25,54,54,0,0,0020900925,2009-10
26,54,58,-4,0,0020900925,2009-10
27,56,60,-4,0,0020900925,2009-10
28,59,60,-1,0,0020900925,2009-10
29,59,62,-3,0,0020900925,2009-10
30,61,64,-3,0,0020900925,2009-10
31,64,66,-2,0,0020900925,2009-10
32,69,68,1,0,0020900925,2009-10
33,71,71,0,0,0020900925,2009-10
34,72,76,-4,0,0020900925,2009-10
35,76,78,-2,0,0020900925,2009-10
36,76,81,-5,0,0020900925,2009-10
37,76,81,-5,0,0020900925,2009-10
38,76,83,-7,0,0020900925,2009-10
39,76,83,-7,0,0020900925,2009-10
40,78,84,-6,0,0020900925,2009-10
41,83,84,-1,0,0020900925,2009-10
42,85,86,-1,0,0020900925,2009-10
43,85,90,-5,0,0020900925,2009-10
44,85,94,-9,0,0020900925,2009-10
45,87,96,-9,0,0020900925,2009-10
46,87,99,-12,0,0020900925,2009-10
47,87,99,-12,0,0020900925,2009-10
48,90,101,-11,0,0020900925,2009-10
49,90,101,-11,0,0020900925,2009-10
1,2,0,2,1,0029900858,1999-00
2,2,1,1,1,0029900858,1999-00
3,2,3,-1,1,0029900858,1999-00
4,2,5,-3,1,0029900858,1999-00
5,2,7,-5,1,0029900858,1999-00
6,2,9,-7,1,0029900858,1999-00
7,7,11,-4,1,0029900858,1999-00
8,9,13,-4,1,0029900858,1999-00
9,13,13,0,1,0029900858,1999-00
10,13,18,-5,1,0029900858,1999-00
11,13,22,-9,1,0029900858,1999-00
12,18,22,-4,1,0029900858,1999-00
13,21,26,-5,1,0029900858,1999-00
14,23,28,-5,1,0029900858,1999-00
15,25,32,-7,1,0029900858,1999-00
16,29,34,-5,1,0029900858,1999-00
17,33,34,-1,1,0029900858,1999-00
18,38,34,4,1,0029900858,1999-00
19,40,36,4,1,0029900858,1999-00
20,43,38,5,1,0029900858,1999-00
21,44,43,1,1,0029900858,1999-00
22,44,45,-1,1,0029900858,1999-00
23,45,47,-2,1,0029900858,1999-00
24,47,52,-5,1,0029900858,1999-00
25,52,54,-2,1,0029900858,1999-00
26,56,54,2,1,0029900858,1999-00
27,59,54,5,1,0029900858,1999-00
28,60,54,6,1,0029900858,1999-00
29,62,55,7,1,0029900858,1999-00
30,62,59,3,1,0029900858,1999-00
31,67,61,6,1,0029900858,1999-00
32,69,63,6,1,0029900858,1999-00
33,72,65,7,1,0029900858,1999-00
34,76,67,9,1,0029900858,1999-00
35,76,69,7,1,0029900858,1999-00
36,81,70,11,1,0029900858,1999-00
37,84,71,13,1,0029900858,1999-00
38,84,71,13,1,0029900858,1999-00
39,84,74,10,1,0029900858,1999-00
40,87,78,9,1,0029900858,1999-00
41,90,80,10,1,0029900858,1999-00
42,92,80,12,1,0029900858,1999-00
43,94,80,14,1,0029900858,1999-00
44,97,82,15,1,0029900858,1999-00
45,99,84,15,1,0029900858,1999-00
46,101,87,14,1,0029900858,1999-00
47,104,90,14,1,0029900858,1999-00
48,109,90,19,1,0029900858,1999-00
49,109,90,19,1,0029900858,1999-00
1,0,0,0,0,0020300736,2003-04
2,1,5,-4,0,0020300736,2003-04
3,3,9,-6,0,0020300736,2003-04
4,5,9,-4,0,0020300736,2003-04
5,9,12,-3,0,0020300736,2003-04
6,11,14,-3,0,0020300736,2003-04
7,15,14,1,0,0020300736,2003-04
8,15,16,-1,0,0020300736,2003-04
9,17,21,-4,0,0020300736,2003-04
10,19,23,-4,0,0020300736,2003-04
11,21,25,-4,0,0020300736,2003-04
12,24,27,-3,0,0020300736,2003-04
13,29,29,0,0,0020300736,2003-04
14,29,31,-2,0,0020300736,2003-04
15,31,33,-2,0,0020300736,2003-04
16,33,33,0,0,0020300736,2003-04
17,35,33,2,0,0020300736,2003-04
18,41,35,6,0,0020300736,2003-04
19,41,37,4,0,0020300736,2003-04
20,45,41,4,0,0020300736,2003-04
21,45,41,4,0,0020300736,2003-04
22,47,46,1,0,0020300736,2003-04
23,49,48,1,0,0020300736,2003-04
24,51,54,-3,0,0020300736,2003-04
25,53,54,-1,0,0020300736,2003-04
26,58,54,4,0,0020300736,2003-04
27,62,56,6,0,0020300736,2003-04
28,62,60,2,0,0020300736,2003-04
29,66,62,4,0,0020300736,2003-04
30,68,64,4,0,0020300736,2003-04
31,70,66,4,0,0020300736,2003-04
32,70,68,2,0,0020300736,2003-04
33,70,71,-1,0,0020300736,2003-04
34,70,74,-4,0,0020300736,2003-04
35,72,76,-4,0,0020300736,2003-04
36,74,81,-7,0,0020300736,2003-04
37,74,84,-10,0,0020300736,2003-04
38,76,87,-11,0,0020300736,2003-04
39,78,87,-9,0,0020300736,2003-04
40,81,87,-6,0,0020300736,2003-04
41,83,87,-4,0,0020300736,2003-04
42,83,93,-10,0,0020300736,2003-04
43,84,97,-13,0,0020300736,2003-04
44,86,99,-13,0,0020300736,2003-04
45,88,102,-14,0,0020300736,2003-04
46,92,108,-16,0,0020300736,2003-04
47,92,111,-19,0,0020300736,2003-04
48,92,115,-23,0,0020300736,2003-04
49,92,115,-23,0,0020300736,2003-04
1,0,3,-3,0,0029800528,1998-99
2,2,5,-3,0,0029800528,1998-99
3,2,10,-8,0,0029800528,1998-99
4,6,12,-6,0,0029800528,1998-99
5,6,17,-11,0,0029800528,1998-99
6,8,21,-13,0,0029800528,1998-99
7,10,26,-16,0,0029800528,1998-99
8,14,28,-14,0,0029800528,1998-99
9,16,28,-12,0,0029800528,1998-99
10,18,29,-11,0,0029800528,1998-99
11,22,29,-7,0,0029800528,1998-99
12,22,31,-9,0,0029800528,1998-99
13,22,34,-12,0,0029800528,1998-99
14,24,37,-13,0,0029800528,1998-99
15,27,39,-12,0,0029800528,1998-99
16,27,42,-15,0,0029800528,1998-99
17,29,44,-15,0,0029800528,1998-99
18,31,46,-15,0,0029800528,1998-99
19,35,46,-11,0,0029800528,1998-99
20,38,48,-10,0,0029800528,1998-99
21,40,53,-13,0,0029800528,1998-99
22,43,55,-12,0,0029800528,1998-99
23,45,55,-10,0,0029800528,1998-99
24,47,55,-8,0,0029800528,1998-99
25,48,57,-9,0,0029800528,1998-99
26,50,59,-9,0,0029800528,1998-99
27,50,62,-12,0,0029800528,1998-99
28,54,65,-11,0,0029800528,1998-99
29,58,67,-9,0,0029800528,1998-99
30,60,69,-9,0,0029800528,1998-99
31,62,71,-9,0,0029800528,1998-99
32,64,76,-12,0,0029800528,1998-99
33,64,76,-12,0,0029800528,1998-99
34,64,78,-14,0,0029800528,1998-99
35,66,81,-15,0,0029800528,1998-99
36,68,81,-13,0,0029800528,1998-99
37,68,83,-15,0,0029800528,1998-99
38,70,85,-15,0,0029800528,1998-99
39,70,87,-17,0,0029800528,1998-99
40,74,87,-13,0,0029800528,1998-99
41,77,87,-10,0,0029800528,1998-99
42,79,89,-10,0,0029800528,1998-99
43,79,93,-14,0,0029800528,1998-99
44,79,96,-17,0,0029800528,1998-99
45,81,98,-17,0,0029800528,1998-99
46,83,100,-17,0,0029800528,1998-99
47,87,103,-16,0,0029800528,1998-99
48,89,103,-14,0,0029800528,1998-99
49,89,103,-14,0,0029800528,1998-99
1,2,0,2,0,0020701046,2007-08
2,4,0,4,0,0020701046,2007-08
3,6,2,4,0,0020701046,2007-08
4,7,6,1,0,0020701046,2007-08
5,9,9,0,0,0020701046,2007-08
6,11,11,0,0,0020701046,2007-08
7,13,13,0,0,0020701046,2007-08
8,15,13,2,0,0020701046,2007-08
9,17,15,2,0,0020701046,2007-08
10,20,15,5,0,0020701046,2007-08
11,25,17,8,0,0020701046,2007-08
12,25,17,8,0,0020701046,2007-08
13,25,17,8,0,0020701046,2007-08
14,25,19,6,0,0020701046,2007-08
15,27,21,6,0,0020701046,2007-08
16,29,21,8,0,0020701046,2007-08
17,29,23,6,0,0020701046,2007-08
18,29,23,6,0,0020701046,2007-08
19,31,23,8,0,0020701046,2007-08
20,31,23,8,0,0020701046,2007-08
21,33,24,9,0,0020701046,2007-08
22,33,27,6,0,0020701046,2007-08
23,37,28,9,0,0020701046,2007-08
24,37,32,5,0,0020701046,2007-08
25,37,34,3,0,0020701046,2007-08
26,37,36,1,0,0020701046,2007-08
27,39,40,-1,0,0020701046,2007-08
28,39,40,-1,0,0020701046,2007-08
29,40,42,-2,0,0020701046,2007-08
30,40,42,-2,0,0020701046,2007-08
31,40,45,-5,0,0020701046,2007-08
32,41,47,-6,0,0020701046,2007-08
33,43,47,-4,0,0020701046,2007-08
34,48,50,-2,0,0020701046,2007-08
35,50,52,-2,0,0020701046,2007-08
36,50,54,-4,0,0020701046,2007-08
37,52,56,-4,0,0020701046,2007-08
38,55,56,-1,0,0020701046,2007-08
39,55,58,-3,0,0020701046,2007-08
40,55,58,-3,0,0020701046,2007-08
41,55,58,-3,0,0020701046,2007-08
42,59,62,-3,0,0020701046,2007-08
43,63,67,-4,0,0020701046,2007-08
44,64,67,-3,0,0020701046,2007-08
45,69,72,-3,0,0020701046,2007-08
46,71,72,-1,0,0020701046,2007-08
47,71,72,-1,0,0020701046,2007-08
48,73,78,-5,0,0020701046,2007-08
49,73,78,-5,0,0020701046,2007-08
1,2,0,2,0,0020000302,2000-01
2,6,5,1,0,0020000302,2000-01
3,8,10,-2,0,0020000302,2000-01
4,11,12,-1,0,0020000302,2000-01
5,13,16,-3,0,0020000302,2000-01
6,16,16,0,0,0020000302,2000-01
7,18,20,-2,0,0020000302,2000-01
8,20,22,-2,0,0020000302,2000-01
9,20,24,-4,0,0020000302,2000-01
10,22,24,-2,0,0020000302,2000-01
11,24,24,0,0,0020000302,2000-01
12,25,26,-1,0,0020000302,2000-01
13,25,26,-1,0,0020000302,2000-01
14,29,26,3,0,0020000302,2000-01
15,29,27,2,0,0020000302,2000-01
16,34,29,5,0,0020000302,2000-01
17,36,31,5,0,0020000302,2000-01
18,40,32,8,0,0020000302,2000-01
19,40,34,6,0,0020000302,2000-01
20,44,34,10,0,0020000302,2000-01
21,44,37,7,0,0020000302,2000-01
22,46,41,5,0,0020000302,2000-01
23,46,43,3,0,0020000302,2000-01
24,46,45,1,0,0020000302,2000-01
25,46,45,1,0,0020000302,2000-01
26,48,49,-1,0,0020000302,2000-01
27,52,49,3,0,0020000302,2000-01
28,54,52,2,0,0020000302,2000-01
29,56,52,4,0,0020000302,2000-01
30,58,56,2,0,0020000302,2000-01
31,58,58,0,0,0020000302,2000-01
32,58,63,-5,0,0020000302,2000-01
33,58,65,-7,0,0020000302,2000-01
34,58,68,-10,0,0020000302,2000-01
35,59,68,-9,0,0020000302,2000-01
36,59,70,-11,0,0020000302,2000-01
37,59,72,-13,0,0020000302,2000-01
38,61,74,-13,0,0020000302,2000-01
39,62,77,-15,0,0020000302,2000-01
40,62,79,-17,0,0020000302,2000-01
41,62,81,-19,0,0020000302,2000-01
42,64,81,-17,0,0020000302,2000-01
43,66,86,-20,0,0020000302,2000-01
44,71,86,-15,0,0020000302,2000-01
45,77,88,-11,0,0020000302,2000-01
46,77,88,-11,0,0020000302,2000-01
47,78,90,-12,0,0020000302,2000-01
48,80,92,-12,0,0020000302,2000-01
49,80,92,-12,0,0020000302,2000-01
1,0,0,0,1,0020100967,2001-02
2,4,0,4,1,0020100967,2001-02
3,5,2,3,1,0020100967,2001-02
4,5,6,-1,1,0020100967,2001-02
5,9,9,0,1,0020100967,2001-02
6,11,11,0,1,0020100967,2001-02
7,13,15,-2,1,0020100967,2001-02
8,13,17,-4,1,0020100967,2001-02
9,15,17,-2,1,0020100967,2001-02
10,19,17,2,1,0020100967,2001-02
11,19,20,-1,1,0020100967,2001-02
12,19,22,-3,1,0020100967,2001-02
13,23,22,1,1,0020100967,2001-02
14,27,24,3,1,0020100967,2001-02
15,29,24,5,1,0020100967,2001-02
16,32,26,6,1,0020100967,2001-02
17,32,26,6,1,0020100967,2001-02
18,37,28,9,1,0020100967,2001-02
19,37,30,7,1,0020100967,2001-02
20,41,32,9,1,0020100967,2001-02
21,41,33,8,1,0020100967,2001-02
22,41,35,6,1,0020100967,2001-02
23,45,35,10,1,0020100967,2001-02
24,45,38,7,1,0020100967,2001-02
25,47,39,8,1,0020100967,2001-02
26,49,39,10,1,0020100967,2001-02
27,51,44,7,1,0020100967,2001-02
28,51,46,5,1,0020100967,2001-02
29,53,50,3,1,0020100967,2001-02
30,54,50,4,1,0020100967,2001-02
31,54,50,4,1,0020100967,2001-02
32,56,54,2,1,0020100967,2001-02
33,58,54,4,1,0020100967,2001-02
34,60,56,4,1,0020100967,2001-02
35,60,57,3,1,0020100967,2001-02
36,60,61,-1,1,0020100967,2001-02
37,65,65,0,1,0020100967,2001-02
38,67,67,0,1,0020100967,2001-02
39,67,69,-2,1,0020100967,2001-02
40,69,69,0,1,0020100967,2001-02
41,71,69,2,1,0020100967,2001-02
42,71,71,0,1,0020100967,2001-02
43,73,71,2,1,0020100967,2001-02
44,73,73,0,1,0020100967,2001-02
45,75,75,0,1,0020100967,2001-02
46,78,75,3,1,0020100967,2001-02
47,80,77,3,1,0020100967,2001-02
48,82,77,5,1,0020100967,2001-02
49,82,77,5,1,0020100967,2001-02
1,3,2,1,1,0021700912,2017-18
2,5,2,3,1,0021700912,2017-18
3,5,4,1,1,0021700912,2017-18
4,9,6,3,1,0021700912,2017-18
5,14,8,6,1,0021700912,2017-18
6,16,13,3,1,0021700912,2017-18
7,18,16,2,1,0021700912,2017-18
8,20,18,2,1,0021700912,2017-18
9,20,20,0,1,0021700912,2017-18
10,20,22,-2,1,0021700912,2017-18
11,20,27,-7,1,0021700912,2017-18
12,24,33,-9,1,0021700912,2017-18
13,30,35,-5,1,0021700912,2017-18
14,30,41,-11,1,0021700912,2017-18
15,35,43,-8,1,0021700912,2017-18
16,37,45,-8,1,0021700912,2017-18
17,39,45,-6,1,0021700912,2017-18
18,41,48,-7,1,0021700912,2017-18
19,43,51,-8,1,0021700912,2017-18
20,46,51,-5,1,0021700912,2017-18
21,48,55,-7,1,0021700912,2017-18
22,48,55,-7,1,0021700912,2017-18
23,48,58,-10,1,0021700912,2017-18
24,52,58,-6,1,0021700912,2017-18
25,56,60,-4,1,0021700912,2017-18
26,56,60,-4,1,0021700912,2017-18
27,57,63,-6,1,0021700912,2017-18
28,61,67,-6,1,0021700912,2017-18
29,63,72,-9,1,0021700912,2017-18
30,63,76,-13,1,0021700912,2017-18
31,63,80,-17,1,0021700912,2017-18
32,63,82,-19,1,0021700912,2017-18
33,68,84,-16,1,0021700912,2017-18
34,73,86,-13,1,0021700912,2017-18
35,77,86,-9,1,0021700912,2017-18
36,79,88,-9,1,0021700912,2017-18
37,84,88,-4,1,0021700912,2017-18
38,89,88,1,1,0021700912,2017-18
39,94,90,4,1,0021700912,2017-18
40,100,92,8,1,0021700912,2017-18
41,102,96,6,1,0021700912,2017-18
42,104,102,2,1,0021700912,2017-18
43,106,106,0,1,0021700912,2017-18
44,111,108,3,1,0021700912,2017-18
45,115,108,7,1,0021700912,2017-18
46,118,111,7,1,0021700912,2017-18
47,118,111,7,1,0021700912,2017-18
48,122,120,2,1,0021700912,2017-18
49,122,120,2,1,0021700912,2017-18
1,2,2,0,1,0020000229,2000-01
2,6,2,4,1,0020000229,2000-01
3,10,6,4,1,0020000229,2000-01
4,15,8,7,1,0020000229,2000-01
5,19,8,11,1,0020000229,2000-01
6,21,8,13,1,0020000229,2000-01
7,25,10,15,1,0020000229,2000-01
8,27,10,17,1,0020000229,2000-01
9,27,13,14,1,0020000229,2000-01
10,29,15,14,1,0020000229,2000-01
11,31,17,14,1,0020000229,2000-01
12,33,22,11,1,0020000229,2000-01
13,33,22,11,1,0020000229,2000-01
14,33,24,9,1,0020000229,2000-01
15,35,28,7,1,0020000229,2000-01
16,37,30,7,1,0020000229,2000-01
17,39,32,7,1,0020000229,2000-01
18,39,36,3,1,0020000229,2000-01
19,41,39,2,1,0020000229,2000-01
20,44,42,2,1,0020000229,2000-01
21,44,44,0,1,0020000229,2000-01
22,47,44,3,1,0020000229,2000-01
23,49,44,5,1,0020000229,2000-01
24,51,46,5,1,0020000229,2000-01
25,51,49,2,1,0020000229,2000-01
26,54,49,5,1,0020000229,2000-01
27,56,51,5,1,0020000229,2000-01
28,56,55,1,1,0020000229,2000-01
29,58,57,1,1,0020000229,2000-01
30,58,59,-1,1,0020000229,2000-01
31,59,61,-2,1,0020000229,2000-01
32,62,63,-1,1,0020000229,2000-01
33,62,65,-3,1,0020000229,2000-01
34,64,67,-3,1,0020000229,2000-01
35,66,69,-3,1,0020000229,2000-01
36,70,69,1,1,0020000229,2000-01
37,70,69,1,1,0020000229,2000-01
38,70,72,-2,1,0020000229,2000-01
39,72,72,0,1,0020000229,2000-01
40,74,72,2,1,0020000229,2000-01
41,75,74,1,1,0020000229,2000-01
42,77,76,1,1,0020000229,2000-01
43,80,76,4,1,0020000229,2000-01
44,81,78,3,1,0020000229,2000-01
45,83,80,3,1,0020000229,2000-01
46,85,82,3,1,0020000229,2000-01
47,86,83,3,1,0020000229,2000-01
48,91,86,5,1,0020000229,2000-01
49,91,86,5,1,0020000229,2000-01
1,2,0,2,1,0020500299,2005-06
2,6,5,1,1,0020500299,2005-06
3,11,5,6,1,0020500299,2005-06
4,14,9,5,1,0020500299,2005-06
5,16,11,5,1,0020500299,2005-06
6,23,11,12,1,0020500299,2005-06
7,25,13,12,1,0020500299,2005-06
8,27,15,12,1,0020500299,2005-06
9,27,18,9,1,0020500299,2005-06
10,29,18,11,1,0020500299,2005-06
11,31,20,11,1,0020500299,2005-06
12,31,23,8,1,0020500299,2005-06
13,31,23,8,1,0020500299,2005-06
14,35,25,10,1,0020500299,2005-06
15,37,28,9,1,0020500299,2005-06
16,39,30,9,1,0020500299,2005-06
17,39,32,7,1,0020500299,2005-06
18,44,32,12,1,0020500299,2005-06
19,44,34,10,1,0020500299,2005-06
20,44,34,10,1,0020500299,2005-06
21,46,34,12,1,0020500299,2005-06
22,48,38,10,1,0020500299,2005-06
23,50,40,10,1,0020500299,2005-06
24,54,46,8,1,0020500299,2005-06
25,54,46,8,1,0020500299,2005-06
26,56,49,7,1,0020500299,2005-06
27,58,53,5,1,0020500299,2005-06
28,60,55,5,1,0020500299,2005-06
29,64,57,7,1,0020500299,2005-06
30,68,57,11,1,0020500299,2005-06
31,68,59,9,1,0020500299,2005-06
32,72,59,13,1,0020500299,2005-06
33,72,59,13,1,0020500299,2005-06
34,72,61,11,1,0020500299,2005-06
35,73,62,11,1,0020500299,2005-06
36,73,62,11,1,0020500299,2005-06
37,73,62,11,1,0020500299,2005-06
38,75,64,11,1,0020500299,2005-06
39,75,66,9,1,0020500299,2005-06
40,75,66,9,1,0020500299,2005-06
41,80,70,10,1,0020500299,2005-06
42,82,70,12,1,0020500299,2005-06
43,84,72,12,1,0020500299,2005-06
44,84,75,9,1,0020500299,2005-06
45,87,75,12,1,0020500299,2005-06
46,87,75,12,1,0020500299,2005-06
47,87,84,3,1,0020500299,2005-06
48,91,87,4,1,0020500299,2005-06
49,91,87,4,1,0020500299,2005-06
1,4,0,4,0,0021300649,2013-14
2,4,2,2,0,0021300649,2013-14
3,4,4,0,0,0021300649,2013-14
4,4,4,0,0,0021300649,2013-14
5,6,4,2,0,0021300649,2013-14
6,8,4,4,0,0021300649,2013-14
7,8,6,2,0,0021300649,2013-14
8,10,8,2,0,0021300649,2013-14
9,12,8,4,0,0021300649,2013-14
10,12,10,2,0,0021300649,2013-14
11,12,13,-1,0,0021300649,2013-14
12,14,16,-2,0,0021300649,2013-14
13,16,18,-2,0,0021300649,2013-14
14,19,20,-1,0,0021300649,2013-14
15,19,22,-3,0,0021300649,2013-14
16,21,28,-7,0,0021300649,2013-14
17,23,30,-7,0,0021300649,2013-14
18,28,33,-5,0,0021300649,2013-14
19,31,33,-2,0,0021300649,2013-14
20,33,37,-4,0,0021300649,2013-14
21,33,39,-6,0,0021300649,2013-14
22,33,39,-6,0,0021300649,2013-14
23,35,44,-9,0,0021300649,2013-14
24,35,46,-11,0,0021300649,2013-14
25,37,46,-9,0,0021300649,2013-14
26,37,47,-10,0,0021300649,2013-14
27,37,51,-14,0,0021300649,2013-14
28,37,51,-14,0,0021300649,2013-14
29,39,57,-18,0,0021300649,2013-14
30,41,58,-17,0,0021300649,2013-14
31,44,60,-16,0,0021300649,2013-14
32,46,60,-14,0,0021300649,2013-14
33,48,60,-12,0,0021300649,2013-14
34,48,64,-16,0,0021300649,2013-14
35,52,64,-12,0,0021300649,2013-14
36,54,71,-17,0,0021300649,2013-14
37,54,73,-19,0,0021300649,2013-14
38,56,78,-22,0,0021300649,2013-14
39,58,78,-20,0,0021300649,2013-14
40,60,78,-18,0,0021300649,2013-14
41,60,83,-23,0,0021300649,2013-14
42,63,88,-25,0,0021300649,2013-14
43,66,90,-24,0,0021300649,2013-14
44,68,91,-23,0,0021300649,2013-14
45,74,95,-21,0,0021300649,2013-14
46,78,97,-19,0,0021300649,2013-14
47,78,99,-21,0,0021300649,2013-14
48,81,99,-18,0,0021300649,2013-14
49,81,99,-18,0,0021300649,2013-14
1,2,4,-2,0,0029800707,1998-99
2,4,4,0,0,0029800707,1998-99
3,11,4,7,0,0029800707,1998-99
4,11,6,5,0,0029800707,1998-99
5,11,8,3,0,0029800707,1998-99
6,11,12,-1,0,0029800707,1998-99
7,11,14,-3,0,0029800707,1998-99
8,13,17,-4,0,0029800707,1998-99
9,13,20,-7,0,0029800707,1998-99
10,15,24,-9,0,0029800707,1998-99
11,15,24,-9,0,0029800707,1998-99
12,17,29,-12,0,0029800707,1998-99
13,19,29,-10,0,0029800707,1998-99
14,19,31,-12,0,0029800707,1998-99
15,21,34,-13,0,0029800707,1998-99
16,21,34,-13,0,0029800707,1998-99
17,24,36,-12,0,0029800707,1998-99
18,27,38,-11,0,0029800707,1998-99
19,29,38,-9,0,0029800707,1998-99
20,31,40,-9,0,0029800707,1998-99
21,31,43,-12,0,0029800707,1998-99
22,33,45,-12,0,0029800707,1998-99
23,35,47,-12,0,0029800707,1998-99
24,39,50,-11,0,0029800707,1998-99
25,40,52,-12,0,0029800707,1998-99
26,42,52,-10,0,0029800707,1998-99
27,42,54,-12,0,0029800707,1998-99
28,42,58,-16,0,0029800707,1998-99
29,45,58,-13,0,0029800707,1998-99
30,47,58,-11,0,0029800707,1998-99
31,50,61,-11,0,0029800707,1998-99
32,52,66,-14,0,0029800707,1998-99
33,54,68,-14,0,0029800707,1998-99
34,56,72,-16,0,0029800707,1998-99
35,58,72,-14,0,0029800707,1998-99
36,60,76,-16,0,0029800707,1998-99
37,60,77,-17,0,0029800707,1998-99
38,60,79,-19,0,0029800707,1998-99
39,64,79,-15,0,0029800707,1998-99
40,64,81,-17,0,0029800707,1998-99
41,66,84,-18,0,0029800707,1998-99
42,68,87,-19,0,0029800707,1998-99
43,68,89,-21,0,0029800707,1998-99
44,69,91,-22,0,0029800707,1998-99
45,72,91,-19,0,0029800707,1998-99
46,72,95,-23,0,0029800707,1998-99
47,74,97,-23,0,0029800707,1998-99
48,78,100,-22,0,0029800707,1998-99
49,78,100,-22,0,0029800707,1998-99
1,0,2,-2,0,0020200673,2002-03
2,4,5,-1,0,0020200673,2002-03
3,8,7,1,0,0020200673,2002-03
4,10,9,1,0,0020200673,2002-03
5,12,11,1,0,0020200673,2002-03
6,15,11,4,0,0020200673,2002-03
7,17,16,1,0,0020200673,2002-03
8,19,19,0,0,0020200673,2002-03
9,22,19,3,0,0020200673,2002-03
10,27,21,6,0,0020200673,2002-03
11,29,25,4,0,0020200673,2002-03
12,31,27,4,0,0020200673,2002-03
13,34,31,3,0,0020200673,2002-03
14,36,34,2,0,0020200673,2002-03
15,36,38,-2,0,0020200673,2002-03
16,36,41,-5,0,0020200673,2002-03
17,40,43,-3,0,0020200673,2002-03
18,42,46,-4,0,0020200673,2002-03
19,42,49,-7,0,0020200673,2002-03
20,44,52,-8,0,0020200673,2002-03
21,44,56,-12,0,0020200673,2002-03
22,46,56,-10,0,0020200673,2002-03
23,49,58,-9,0,0020200673,2002-03
24,54,58,-4,0,0020200673,2002-03
25,56,62,-6,0,0020200673,2002-03
26,56,64,-8,0,0020200673,2002-03
27,56,66,-10,0,0020200673,2002-03
28,60,68,-8,0,0020200673,2002-03
29,60,71,-11,0,0020200673,2002-03
30,63,73,-10,0,0020200673,2002-03
31,63,77,-14,0,0020200673,2002-03
32,63,83,-20,0,0020200673,2002-03
33,63,88,-25,0,0020200673,2002-03
34,67,88,-21,0,0020200673,2002-03
35,70,94,-24,0,0020200673,2002-03
36,70,98,-28,0,0020200673,2002-03
37,74,100,-26,0,0020200673,2002-03
38,74,100,-26,0,0020200673,2002-03
39,76,105,-29,0,0020200673,2002-03
40,80,108,-28,0,0020200673,2002-03
41,82,108,-26,0,0020200673,2002-03
42,84,108,-24,0,0020200673,2002-03
43,86,110,-24,0,0020200673,2002-03
44,88,115,-27,0,0020200673,2002-03
45,92,118,-26,0,0020200673,2002-03
46,96,118,-22,0,0020200673,2002-03
47,96,120,-24,0,0020200673,2002-03
48,100,122,-22,0,0020200673,2002-03
49,100,122,-22,0,0020200673,2002-03
1,0,0,0,0,0021800864,2018-19
2,0,5,-5,0,0021800864,2018-19
3,2,7,-5,0,0021800864,2018-19
4,6,12,-6,0,0021800864,2018-19
5,8,14,-6,0,0021800864,2018-19
6,10,16,-6,0,0021800864,2018-19
7,12,18,-6,0,0021800864,2018-19
8,13,21,-8,0,0021800864,2018-19
9,15,24,-9,0,0021800864,2018-19
10,17,28,-11,0,0021800864,2018-19
11,17,31,-14,0,0021800864,2018-19
12,18,33,-15,0,0021800864,2018-19
13,18,33,-15,0,0021800864,2018-19
14,18,36,-18,0,0021800864,2018-19
15,20,40,-20,0,0021800864,2018-19
16,23,43,-20,0,0021800864,2018-19
17,23,47,-24,0,0021800864,2018-19
18,25,50,-25,0,0021800864,2018-19
19,25,53,-28,0,0021800864,2018-19
20,27,55,-28,0,0021800864,2018-19
21,31,55,-24,0,0021800864,2018-19
22,31,59,-28,0,0021800864,2018-19
23,31,64,-33,0,0021800864,2018-19
24,36,69,-33,0,0021800864,2018-19
25,36,74,-38,0,0021800864,2018-19
26,41,75,-34,0,0021800864,2018-19
27,45,77,-32,0,0021800864,2018-19
28,49,80,-31,0,0021800864,2018-19
29,51,83,-32,0,0021800864,2018-19
30,57,86,-29,0,0021800864,2018-19
31,57,88,-31,0,0021800864,2018-19
32,57,90,-33,0,0021800864,2018-19
33,58,90,-32,0,0021800864,2018-19
34,62,96,-34,0,0021800864,2018-19
35,67,98,-31,0,0021800864,2018-19
36,67,98,-31,0,0021800864,2018-19
37,72,101,-29,0,0021800864,2018-19
38,73,103,-30,0,0021800864,2018-19
39,73,103,-30,0,0021800864,2018-19
40,75,107,-32,0,0021800864,2018-19
41,77,107,-30,0,0021800864,2018-19
42,78,107,-29,0,0021800864,2018-19
43,80,109,-29,0,0021800864,2018-19
44,80,114,-34,0,0021800864,2018-19
45,82,114,-32,0,0021800864,2018-19
46,85,120,-35,0,0021800864,2018-19
47,87,124,-37,0,0021800864,2018-19
48,89,127,-38,0,0021800864,2018-19
49,89,127,-38,0,0021800864,2018-19
1,4,2,2,0,0020300525,2003-04
2,6,7,-1,0,0020300525,2003-04
3,7,9,-2,0,0020300525,2003-04
4,12,9,3,0,0020300525,2003-04
5,14,11,3,0,0020300525,2003-04
6,17,14,3,0,0020300525,2003-04
7,22,14,8,0,0020300525,2003-04
8,22,14,8,0,0020300525,2003-04
9,24,16,8,0,0020300525,2003-04
10,26,20,6,0,0020300525,2003-04
11,28,23,5,0,0020300525,2003-04
12,30,23,7,0,0020300525,2003-04
13,32,25,7,0,0020300525,2003-04
14,34,30,4,0,0020300525,2003-04
15,34,30,4,0,0020300525,2003-04
16,35,35,0,0,0020300525,2003-04
17,39,35,4,0,0020300525,2003-04
18,41,42,-1,0,0020300525,2003-04
19,43,45,-2,0,0020300525,2003-04
20,45,49,-4,0,0020300525,2003-04
21,47,50,-3,0,0020300525,2003-04
22,49,51,-2,0,0020300525,2003-04
23,51,53,-2,0,0020300525,2003-04
24,53,55,-2,0,0020300525,2003-04
25,55,57,-2,0,0020300525,2003-04
26,55,59,-4,0,0020300525,2003-04
27,59,63,-4,0,0020300525,2003-04
28,59,65,-6,0,0020300525,2003-04
29,61,69,-8,0,0020300525,2003-04
30,63,72,-9,0,0020300525,2003-04
31,66,74,-8,0,0020300525,2003-04
32,68,79,-11,0,0020300525,2003-04
33,70,80,-10,0,0020300525,2003-04
34,71,83,-12,0,0020300525,2003-04
35,73,85,-12,0,0020300525,2003-04
36,77,90,-13,0,0020300525,2003-04
37,77,90,-13,0,0020300525,2003-04
38,79,90,-11,0,0020300525,2003-04
39,81,95,-14,0,0020300525,2003-04
40,83,98,-15,0,0020300525,2003-04
41,85,103,-18,0,0020300525,2003-04
42,86,103,-17,0,0020300525,2003-04
43,88,104,-16,0,0020300525,2003-04
44,90,106,-16,0,0020300525,2003-04
45,92,109,-17,0,0020300525,2003-04
46,94,111,-17,0,0020300525,2003-04
47,97,113,-16,0,0020300525,2003-04
48,102,115,-13,0,0020300525,2003-04
49,102,115,-13,0,0020300525,2003-04
1,0,2,-2,0,0022100547,2021-22
2,4,4,0,0,0022100547,2021-22
3,11,11,0,0,0022100547,2021-22
4,11,13,-2,0,0022100547,2021-22
5,14,17,-3,0,0022100547,2021-22
6,17,19,-2,0,0022100547,2021-22
7,17,19,-2,0,0022100547,2021-22
8,20,19,1,0,0022100547,2021-22
9,23,21,2,0,0022100547,2021-22
10,26,24,2,0,0022100547,2021-22
11,28,26,2,0,0022100547,2021-22
12,30,30,0,0,0022100547,2021-22
13,35,33,2,0,0022100547,2021-22
14,37,36,1,0,0022100547,2021-22
15,37,38,-1,0,0022100547,2021-22
16,39,38,1,0,0022100547,2021-22
17,41,41,0,0,0022100547,2021-22
18,41,41,0,0,0022100547,2021-22
19,44,45,-1,0,0022100547,2021-22
20,44,50,-6,0,0022100547,2021-22
21,46,52,-6,0,0022100547,2021-22
22,49,54,-5,0,0022100547,2021-22
23,51,58,-7,0,0022100547,2021-22
24,56,58,-2,0,0022100547,2021-22
25,58,58,0,0,0022100547,2021-22
26,60,60,0,0,0022100547,2021-22
27,62,64,-2,0,0022100547,2021-22
28,62,64,-2,0,0022100547,2021-22
29,68,66,2,0,0022100547,2021-22
30,71,66,5,0,0022100547,2021-22
31,76,68,8,0,0022100547,2021-22
32,79,72,7,0,0022100547,2021-22
33,84,73,11,0,0022100547,2021-22
34,84,77,7,0,0022100547,2021-22
35,84,82,2,0,0022100547,2021-22
36,84,85,-1,0,0022100547,2021-22
37,87,90,-3,0,0022100547,2021-22
38,90,92,-2,0,0022100547,2021-22
39,90,94,-4,0,0022100547,2021-22
40,90,94,-4,0,0022100547,2021-22
41,92,97,-5,0,0022100547,2021-22
42,92,99,-7,0,0022100547,2021-22
43,94,99,-5,0,0022100547,2021-22
44,94,103,-9,0,0022100547,2021-22
45,94,103,-9,0,0022100547,2021-22
46,98,105,-7,0,0022100547,2021-22
47,98,105,-7,0,0022100547,2021-22
48,104,108,-4,0,0022100547,2021-22
49,104,108,-4,0,0022100547,2021-22
1,3,4,-1,0,0022200858,2022-23
2,3,6,-3,0,0022200858,2022-23
3,3,11,-8,0,0022200858,2022-23
4,7,13,-6,0,0022200858,2022-23
5,7,17,-10,0,0022200858,2022-23
6,9,22,-13,0,0022200858,2022-23
7,12,22,-10,0,0022200858,2022-23
8,15,27,-12,0,0022200858,2022-23
9,15,29,-14,0,0022200858,2022-23
10,19,29,-10,0,0022200858,2022-23
11,19,34,-15,0,0022200858,2022-23
12,19,34,-15,0,0022200858,2022-23
13,19,34,-15,0,0022200858,2022-23
14,24,36,-12,0,0022200858,2022-23
15,26,39,-13,0,0022200858,2022-23
16,30,39,-9,0,0022200858,2022-23
17,30,44,-14,0,0022200858,2022-23
18,31,44,-13,0,0022200858,2022-23
19,35,46,-11,0,0022200858,2022-23
20,37,50,-13,0,0022200858,2022-23
21,39,55,-16,0,0022200858,2022-23
22,43,57,-14,0,0022200858,2022-23
23,45,62,-17,0,0022200858,2022-23
24,49,65,-16,0,0022200858,2022-23
25,49,67,-18,0,0022200858,2022-23
26,51,72,-21,0,0022200858,2022-23
27,56,72,-16,0,0022200858,2022-23
28,60,72,-12,0,0022200858,2022-23
29,64,76,-12,0,0022200858,2022-23
30,64,78,-14,0,0022200858,2022-23
31,67,80,-13,0,0022200858,2022-23
32,73,84,-11,0,0022200858,2022-23
33,75,87,-12,0,0022200858,2022-23
34,75,87,-12,0,0022200858,2022-23
35,77,89,-12,0,0022200858,2022-23
36,81,91,-10,0,0022200858,2022-23
37,83,93,-10,0,0022200858,2022-23
38,87,95,-8,0,0022200858,2022-23
39,91,95,-4,0,0022200858,2022-23
40,91,97,-6,0,0022200858,2022-23
41,91,101,-10,0,0022200858,2022-23
42,93,103,-10,0,0022200858,2022-23
43,95,105,-10,0,0022200858,2022-23
44,95,105,-10,0,0022200858,2022-23
45,98,107,-9,0,0022200858,2022-23
46,99,109,-10,0,0022200858,2022-23
47,103,115,-12,0,0022200858,2022-23
48,109,117,-8,0,0022200858,2022-23
49,109,117,-8,0,0022200858,2022-23
1,2,0,2,1,0021800964,2018-19
2,6,0,6,1,0021800964,2018-19
3,9,0,9,1,0021800964,2018-19
4,11,2,9,1,0021800964,2018-19
5,13,9,4,1,0021800964,2018-19
6,13,12,1,1,0021800964,2018-19
7,19,12,7,1,0021800964,2018-19
8,22,14,8,1,0021800964,2018-19
9,26,16,10,1,0021800964,2018-19
10,28,21,7,1,0021800964,2018-19
11,28,24,4,1,0021800964,2018-19
12,32,24,8,1,0021800964,2018-19
13,37,24,13,1,0021800964,2018-19
14,40,24,16,1,0021800964,2018-19
15,43,27,16,1,0021800964,2018-19
16,45,32,13,1,0021800964,2018-19
17,49,32,17,1,0021800964,2018-19
18,51,34,17,1,0021800964,2018-19
19,53,39,14,1,0021800964,2018-19
20,57,42,15,1,0021800964,2018-19
21,62,44,18,1,0021800964,2018-19
22,67,47,20,1,0021800964,2018-19
23,69,47,22,1,0021800964,2018-19
24,73,48,25,1,0021800964,2018-19
25,75,50,25,1,0021800964,2018-19
26,75,52,23,1,0021800964,2018-19
27,75,54,21,1,0021800964,2018-19
28,78,56,22,1,0021800964,2018-19
29,84,59,25,1,0021800964,2018-19
30,84,63,21,1,0021800964,2018-19
31,87,67,20,1,0021800964,2018-19
32,87,70,17,1,0021800964,2018-19
33,91,72,19,1,0021800964,2018-19
34,93,76,17,1,0021800964,2018-19
35,97,76,21,1,0021800964,2018-19
36,105,76,29,1,0021800964,2018-19
37,108,79,29,1,0021800964,2018-19
38,110,79,31,1,0021800964,2018-19
39,110,82,28,1,0021800964,2018-19
40,110,85,25,1,0021800964,2018-19
41,112,85,27,1,0021800964,2018-19
42,112,85,27,1,0021800964,2018-19
43,115,87,28,1,0021800964,2018-19
44,117,87,30,1,0021800964,2018-19
45,119,89,30,1,0021800964,2018-19
46,121,91,30,1,0021800964,2018-19
47,126,93,33,1,0021800964,2018-19
48,128,95,33,1,0021800964,2018-19
49,128,95,33,1,0021800964,2018-19
1,0,2,-2,1,0020700385,2007-08
2,4,4,0,1,0020700385,2007-08
3,6,9,-3,1,0020700385,2007-08
4,10,16,-6,1,0020700385,2007-08
5,10,16,-6,1,0020700385,2007-08
6,12,19,-7,1,0020700385,2007-08
7,15,19,-4,1,0020700385,2007-08
8,15,23,-8,1,0020700385,2007-08
9,20,23,-3,1,0020700385,2007-08
10,22,25,-3,1,0020700385,2007-08
11,24,27,-3,1,0020700385,2007-08
12,28,27,1,1,0020700385,2007-08
13,30,27,3,1,0020700385,2007-08
14,32,27,5,1,0020700385,2007-08
15,32,31,1,1,0020700385,2007-08
16,35,31,4,1,0020700385,2007-08
17,35,34,1,1,0020700385,2007-08
18,39,37,2,1,0020700385,2007-08
19,41,40,1,1,0020700385,2007-08
20,42,43,-1,1,0020700385,2007-08
21,45,45,0,1,0020700385,2007-08
22,47,48,-1,1,0020700385,2007-08
23,49,48,1,1,0020700385,2007-08
24,49,50,-1,1,0020700385,2007-08
25,49,52,-3,1,0020700385,2007-08
26,51,54,-3,1,0020700385,2007-08
27,54,56,-2,1,0020700385,2007-08
28,58,57,1,1,0020700385,2007-08
29,60,61,-1,1,0020700385,2007-08
30,64,63,1,1,0020700385,2007-08
31,69,65,4,1,0020700385,2007-08
32,71,65,6,1,0020700385,2007-08
33,73,65,8,1,0020700385,2007-08
34,75,65,10,1,0020700385,2007-08
35,77,67,10,1,0020700385,2007-08
36,79,70,9,1,0020700385,2007-08
37,81,73,8,1,0020700385,2007-08
38,86,73,13,1,0020700385,2007-08
39,88,75,13,1,0020700385,2007-08
40,91,77,14,1,0020700385,2007-08
41,95,78,17,1,0020700385,2007-08
42,97,80,17,1,0020700385,2007-08
43,100,85,15,1,0020700385,2007-08
44,104,87,17,1,0020700385,2007-08
45,108,89,19,1,0020700385,2007-08
46,108,92,16,1,0020700385,2007-08
47,113,92,21,1,0020700385,2007-08
48,113,94,19,1,0020700385,2007-08
49,113,94,19,1,0020700385,2007-08
1,0,4,-4,0,0029700784,1997-98
2,2,4,-2,0,0029700784,1997-98
3,6,6,0,0,0029700784,1997-98
4,6,10,-4,0,0029700784,1997-98
5,8,13,-5,0,0029700784,1997-98
6,8,15,-7,0,0029700784,1997-98
7,10,19,-9,0,0029700784,1997-98
8,12,22,-10,0,0029700784,1997-98
9,18,26,-8,0,0029700784,1997-98
10,18,28,-10,0,0029700784,1997-98
11,18,28,-10,0,0029700784,1997-98
12,18,30,-12,0,0029700784,1997-98
13,18,30,-12,0,0029700784,1997-98
14,18,30,-12,0,0029700784,1997-98
15,18,32,-14,0,0029700784,1997-98
16,18,34,-16,0,0029700784,1997-98
17,18,38,-20,0,0029700784,1997-98
18,22,40,-18,0,0029700784,1997-98
19,24,44,-20,0,0029700784,1997-98
20,26,46,-20,0,0029700784,1997-98
21,27,48,-21,0,0029700784,1997-98
22,29,50,-21,0,0029700784,1997-98
23,31,50,-19,0,0029700784,1997-98
24,33,52,-19,0,0029700784,1997-98
25,33,54,-21,0,0029700784,1997-98
26,34,58,-24,0,0029700784,1997-98
27,34,59,-25,0,0029700784,1997-98
28,36,61,-25,0,0029700784,1997-98
29,39,62,-23,0,0029700784,1997-98
30,39,62,-23,0,0029700784,1997-98
31,40,62,-22,0,0029700784,1997-98
32,40,64,-24,0,0029700784,1997-98
33,44,66,-22,0,0029700784,1997-98
34,46,68,-22,0,0029700784,1997-98
35,46,70,-24,0,0029700784,1997-98
36,48,72,-24,0,0029700784,1997-98
37,50,74,-24,0,0029700784,1997-98
38,52,77,-25,0,0029700784,1997-98
39,56,77,-21,0,0029700784,1997-98
40,58,77,-19,0,0029700784,1997-98
41,60,80,-20,0,0029700784,1997-98
42,63,82,-19,0,0029700784,1997-98
43,65,84,-19,0,0029700784,1997-98
44,65,84,-19,0,0029700784,1997-98
45,67,90,-23,0,0029700784,1997-98
46,71,90,-19,0,0029700784,1997-98
47,73,94,-21,0,0029700784,1997-98
48,75,97,-22,0,0029700784,1997-98
49,75,97,-22,0,0029700784,1997-98
1,2,2,0,0,0020100422,2001-02
2,4,2,2,0,0020100422,2001-02
3,8,4,4,0,0020100422,2001-02
4,8,10,-2,0,0020100422,2001-02
5,10,10,0,0,0020100422,2001-02
6,14,10,4,0,0020100422,2001-02
7,14,14,0,0,0020100422,2001-02
8,16,14,2,0,0020100422,2001-02
9,18,18,0,0,0020100422,2001-02
10,22,21,1,0,0020100422,2001-02
11,25,21,4,0,0020100422,2001-02
12,27,25,2,0,0020100422,2001-02
13,27,27,0,0,0020100422,2001-02
14,32,31,1,0,0020100422,2001-02
15,37,31,6,0,0020100422,2001-02
16,37,35,2,0,0020100422,2001-02
17,39,40,-1,0,0020100422,2001-02
18,43,43,0,0,0020100422,2001-02
19,45,45,0,0,0020100422,2001-02
20,49,46,3,0,0020100422,2001-02
21,49,48,1,0,0020100422,2001-02
22,49,50,-1,0,0020100422,2001-02
23,51,52,-1,0,0020100422,2001-02
24,51,58,-7,0,0020100422,2001-02
25,51,60,-9,0,0020100422,2001-02
26,53,63,-10,0,0020100422,2001-02
27,53,63,-10,0,0020100422,2001-02
28,55,65,-10,0,0020100422,2001-02
29,58,65,-7,0,0020100422,2001-02
30,60,68,-8,0,0020100422,2001-02
31,63,68,-5,0,0020100422,2001-02
32,65,70,-5,0,0020100422,2001-02
33,67,74,-7,0,0020100422,2001-02
34,69,76,-7,0,0020100422,2001-02
35,71,80,-9,0,0020100422,2001-02
36,71,82,-11,0,0020100422,2001-02
37,73,82,-9,0,0020100422,2001-02
38,73,82,-9,0,0020100422,2001-02
39,78,89,-11,0,0020100422,2001-02
40,80,89,-9,0,0020100422,2001-02
41,82,93,-11,0,0020100422,2001-02
42,84,93,-9,0,0020100422,2001-02
43,86,98,-12,0,0020100422,2001-02
44,88,100,-12,0,0020100422,2001-02
45,90,101,-11,0,0020100422,2001-02
46,91,105,-14,0,0020100422,2001-02
47,92,105,-13,0,0020100422,2001-02
48,92,109,-17,0,0020100422,2001-02
49,92,109,-17,0,0020100422,2001-02
1,0,4,-4,0,0021801134,2018-19
2,2,6,-4,0,0021801134,2018-19
3,7,8,-1,0,0021801134,2018-19
4,9,12,-3,0,0021801134,2018-19
5,11,12,-1,0,0021801134,2018-19
6,16,12,4,0,0021801134,2018-19
7,18,12,6,0,0021801134,2018-19
8,19,17,2,0,0021801134,2018-19
9,22,21,1,0,0021801134,2018-19
10,26,26,0,0,0021801134,2018-19
11,28,31,-3,0,0021801134,2018-19
12,30,37,-7,0,0021801134,2018-19
13,30,39,-9,0,0021801134,2018-19
14,35,44,-9,0,0021801134,2018-19
15,37,44,-7,0,0021801134,2018-19
16,39,46,-7,0,0021801134,2018-19
17,41,50,-9,0,0021801134,2018-19
18,44,53,-9,0,0021801134,2018-19
19,46,59,-13,0,0021801134,2018-19
20,49,61,-12,0,0021801134,2018-19
21,54,61,-7,0,0021801134,2018-19
22,59,65,-6,0,0021801134,2018-19
23,60,68,-8,0,0021801134,2018-19
24,62,70,-8,0,0021801134,2018-19
25,64,72,-8,0,0021801134,2018-19
26,64,72,-8,0,0021801134,2018-19
27,66,74,-8,0,0021801134,2018-19
28,68,76,-8,0,0021801134,2018-19
29,71,79,-8,0,0021801134,2018-19
30,75,79,-4,0,0021801134,2018-19
31,75,81,-6,0,0021801134,2018-19
32,77,86,-9,0,0021801134,2018-19
33,77,92,-15,0,0021801134,2018-19
34,82,92,-10,0,0021801134,2018-19
35,87,92,-5,0,0021801134,2018-19
36,87,92,-5,0,0021801134,2018-19
37,90,97,-7,0,0021801134,2018-19
38,94,97,-3,0,0021801134,2018-19
39,96,99,-3,0,0021801134,2018-19
40,97,103,-6,0,0021801134,2018-19
41,100,106,-6,0,0021801134,2018-19
42,103,108,-5,0,0021801134,2018-19
43,108,110,-2,0,0021801134,2018-19
44,110,112,-2,0,0021801134,2018-19
45,116,114,2,0,0021801134,2018-19
46,116,117,-1,0,0021801134,2018-19
47,118,122,-4,0,0021801134,2018-19
48,124,128,-4,0,0021801134,2018-19
49,124,128,-4,0,0021801134,2018-19
1,2,2,0,1,0022000800,2020-21
2,8,2,6,1,0022000800,2020-21
3,13,4,9,1,0022000800,2020-21
4,16,7,9,1,0022000800,2020-21
5,18,9,9,1,0022000800,2020-21
6,18,11,7,1,0022000800,2020-21
7,20,13,7,1,0022000800,2020-21
8,22,15,7,1,0022000800,2020-21
9,23,18,5,1,0022000800,2020-21
10,25,20,5,1,0022000800,2020-21
11,29,23,6,1,0022000800,2020-21
12,33,25,8,1,0022000800,2020-21
13,33,27,6,1,0022000800,2020-21
14,38,31,7,1,0022000800,2020-21
15,41,33,8,1,0022000800,2020-21
16,43,35,8,1,0022000800,2020-21
17,47,38,9,1,0022000800,2020-21
18,49,39,10,1,0022000800,2020-21
19,49,47,2,1,0022000800,2020-21
20,52,50,2,1,0022000800,2020-21
21,52,54,-2,1,0022000800,2020-21
22,56,56,0,1,0022000800,2020-21
23,58,56,2,1,0022000800,2020-21
24,61,58,3,1,0022000800,2020-21
25,64,62,2,1,0022000800,2020-21
26,66,62,4,1,0022000800,2020-21
27,69,62,7,1,0022000800,2020-21
28,73,67,6,1,0022000800,2020-21
29,76,69,7,1,0022000800,2020-21
30,79,69,10,1,0022000800,2020-21
31,81,71,10,1,0022000800,2020-21
32,88,71,17,1,0022000800,2020-21
33,88,75,13,1,0022000800,2020-21
34,88,77,11,1,0022000800,2020-21
35,89,77,12,1,0022000800,2020-21
36,92,77,15,1,0022000800,2020-21
37,95,77,18,1,0022000800,2020-21
38,98,79,19,1,0022000800,2020-21
39,100,83,17,1,0022000800,2020-21
40,105,83,22,1,0022000800,2020-21
41,107,83,24,1,0022000800,2020-21
42,109,85,24,1,0022000800,2020-21
43,111,89,22,1,0022000800,2020-21
44,111,94,17,1,0022000800,2020-21
45,117,94,23,1,0022000800,2020-21
46,123,95,28,1,0022000800,2020-21
47,126,101,25,1,0022000800,2020-21
48,126,101,25,1,0022000800,2020-21
49,126,101,25,1,0022000800,2020-21
1,2,3,-1,1,0022100530,2021-22
2,7,3,4,1,0022100530,2021-22
3,7,8,-1,1,0022100530,2021-22
4,12,12,0,1,0022100530,2021-22
5,14,12,2,1,0022100530,2021-22
6,16,15,1,1,0022100530,2021-22
7,16,15,1,1,0022100530,2021-22
8,18,15,3,1,0022100530,2021-22
9,18,15,3,1,0022100530,2021-22
10,21,17,4,1,0022100530,2021-22
11,23,19,4,1,0022100530,2021-22
12,25,23,2,1,0022100530,2021-22
13,30,25,5,1,0022100530,2021-22
14,33,27,6,1,0022100530,2021-22
15,35,29,6,1,0022100530,2021-22
16,35,33,2,1,0022100530,2021-22
17,35,36,-1,1,0022100530,2021-22
18,40,36,4,1,0022100530,2021-22
19,40,40,0,1,0022100530,2021-22
20,42,40,2,1,0022100530,2021-22
21,44,41,3,1,0022100530,2021-22
22,46,45,1,1,0022100530,2021-22
23,52,48,4,1,0022100530,2021-22
24,54,50,4,1,0022100530,2021-22
25,54,50,4,1,0022100530,2021-22
26,57,52,5,1,0022100530,2021-22
27,61,55,6,1,0022100530,2021-22
28,63,57,6,1,0022100530,2021-22
29,69,60,9,1,0022100530,2021-22
30,72,64,8,1,0022100530,2021-22
31,73,67,6,1,0022100530,2021-22
32,73,70,3,1,0022100530,2021-22
33,77,74,3,1,0022100530,2021-22
34,82,74,8,1,0022100530,2021-22
35,82,78,4,1,0022100530,2021-22
36,82,79,3,1,0022100530,2021-22
37,84,79,5,1,0022100530,2021-22
38,86,80,6,1,0022100530,2021-22
39,88,84,4,1,0022100530,2021-22
40,90,86,4,1,0022100530,2021-22
41,94,90,4,1,0022100530,2021-22
42,94,93,1,1,0022100530,2021-22
43,94,97,-3,1,0022100530,2021-22
44,96,99,-3,1,0022100530,2021-22
45,96,101,-5,1,0022100530,2021-22
46,101,104,-3,1,0022100530,2021-22
47,103,104,-1,1,0022100530,2021-22
48,105,106,-1,1,0022100530,2021-22
49,108,106,2,1,0022100530,2021-22
1,2,4,-2,0,0029800131,1998-99
2,5,8,-3,0,0029800131,1998-99
3,10,10,0,0,0029800131,1998-99
4,12,12,0,0,0029800131,1998-99
5,14,16,-2,0,0029800131,1998-99
6,16,20,-4,0,0029800131,1998-99
7,18,20,-2,0,0029800131,1998-99
8,20,25,-5,0,0029800131,1998-99
9,26,27,-1,0,0029800131,1998-99
10,31,27,4,0,0029800131,1998-99
11,33,29,4,0,0029800131,1998-99
12,37,29,8,0,0029800131,1998-99
13,39,31,8,0,0029800131,1998-99
14,41,32,9,0,0029800131,1998-99
15,41,34,7,0,0029800131,1998-99
16,45,36,9,0,0029800131,1998-99
17,49,38,11,0,0029800131,1998-99
18,52,42,10,0,0029800131,1998-99
19,52,45,7,0,0029800131,1998-99
20,54,49,5,0,0029800131,1998-99
21,56,53,3,0,0029800131,1998-99
22,56,55,1,0,0029800131,1998-99
23,56,57,-1,0,0029800131,1998-99
24,56,59,-3,0,0029800131,1998-99
25,56,59,-3,0,0029800131,1998-99
26,58,61,-3,0,0029800131,1998-99
27,60,63,-3,0,0029800131,1998-99
28,62,68,-6,0,0029800131,1998-99
29,64,70,-6,0,0029800131,1998-99
30,65,72,-7,0,0029800131,1998-99
31,65,72,-7,0,0029800131,1998-99
32,67,72,-5,0,0029800131,1998-99
33,67,78,-11,0,0029800131,1998-99
34,72,78,-6,0,0029800131,1998-99
35,76,80,-4,0,0029800131,1998-99
36,76,82,-6,0,0029800131,1998-99
37,78,84,-6,0,0029800131,1998-99
38,82,87,-5,0,0029800131,1998-99
39,82,87,-5,0,0029800131,1998-99
40,85,89,-4,0,0029800131,1998-99
41,85,89,-4,0,0029800131,1998-99
42,85,94,-9,0,0029800131,1998-99
43,87,98,-11,0,0029800131,1998-99
44,91,98,-7,0,0029800131,1998-99
45,94,98,-4,0,0029800131,1998-99
46,94,101,-7,0,0029800131,1998-99
47,96,104,-8,0,0029800131,1998-99
48,96,107,-11,0,0029800131,1998-99
49,96,107,-11,0,0029800131,1998-99
1,2,0,2,0,0020900813,2009-10
2,4,2,2,0,0020900813,2009-10
3,4,6,-2,0,0020900813,2009-10
4,7,10,-3,0,0020900813,2009-10
5,11,12,-1,0,0020900813,2009-10
6,13,12,1,0,0020900813,2009-10
7,16,12,4,0,0020900813,2009-10
8,16,13,3,0,0020900813,2009-10
9,18,19,-1,0,0020900813,2009-10
10,20,23,-3,0,0020900813,2009-10
11,23,24,-1,0,0020900813,2009-10
12,23,26,-3,0,0020900813,2009-10
13,23,28,-5,0,0020900813,2009-10
14,25,30,-5,0,0020900813,2009-10
15,25,34,-9,0,0020900813,2009-10
16,27,34,-7,0,0020900813,2009-10
17,30,38,-8,0,0020900813,2009-10
18,32,38,-6,0,0020900813,2009-10
19,34,40,-6,0,0020900813,2009-10
20,36,42,-6,0,0020900813,2009-10
21,38,46,-8,0,0020900813,2009-10
22,40,46,-6,0,0020900813,2009-10
23,44,49,-5,0,0020900813,2009-10
24,50,49,1,0,0020900813,2009-10
25,52,49,3,0,0020900813,2009-10
26,52,49,3,0,0020900813,2009-10
27,54,51,3,0,0020900813,2009-10
28,56,55,1,0,0020900813,2009-10
29,57,57,0,0,0020900813,2009-10
30,59,59,0,0,0020900813,2009-10
31,59,59,0,0,0020900813,2009-10
32,59,59,0,0,0020900813,2009-10
33,62,61,1,0,0020900813,2009-10
34,62,63,-1,0,0020900813,2009-10
35,62,67,-5,0,0020900813,2009-10
36,66,70,-4,0,0020900813,2009-10
37,68,70,-2,0,0020900813,2009-10
38,70,72,-2,0,0020900813,2009-10
39,70,76,-6,0,0020900813,2009-10
40,70,78,-8,0,0020900813,2009-10
41,70,80,-10,0,0020900813,2009-10
42,70,81,-11,0,0020900813,2009-10
43,72,83,-11,0,0020900813,2009-10
44,74,85,-11,0,0020900813,2009-10
45,76,85,-9,0,0020900813,2009-10
46,76,85,-9,0,0020900813,2009-10
47,79,86,-7,0,0020900813,2009-10
48,80,88,-8,0,0020900813,2009-10
49,80,88,-8,0,0020900813,2009-10
1,1,0,1,0,0020000835,2000-01
2,4,2,2,0,0020000835,2000-01
3,4,2,2,0,0020000835,2000-01
4,4,4,0,0,0020000835,2000-01
5,5,8,-3,0,0020000835,2000-01
6,5,9,-4,0,0020000835,2000-01
7,5,11,-6,0,0020000835,2000-01
8,5,13,-8,0,0020000835,2000-01
9,7,15,-8,0,0020000835,2000-01
10,9,15,-6,0,0020000835,2000-01
11,11,17,-6,0,0020000835,2000-01
12,12,19,-7,0,0020000835,2000-01
13,16,22,-6,0,0020000835,2000-01
14,20,22,-2,0,0020000835,2000-01
15,24,24,0,0,0020000835,2000-01
16,28,26,2,0,0020000835,2000-01
17,28,28,0,0,0020000835,2000-01
18,28,30,-2,0,0020000835,2000-01
19,28,34,-6,0,0020000835,2000-01
20,28,34,-6,0,0020000835,2000-01
21,30,39,-9,0,0020000835,2000-01
22,32,41,-9,0,0020000835,2000-01
23,32,43,-11,0,0020000835,2000-01
24,38,45,-7,0,0020000835,2000-01
25,38,47,-9,0,0020000835,2000-01
26,40,51,-11,0,0020000835,2000-01
27,44,53,-9,0,0020000835,2000-01
28,47,53,-6,0,0020000835,2000-01
29,49,56,-7,0,0020000835,2000-01
30,49,56,-7,0,0020000835,2000-01
31,51,57,-6,0,0020000835,2000-01
32,51,59,-8,0,0020000835,2000-01
33,53,61,-8,0,0020000835,2000-01
34,53,63,-10,0,0020000835,2000-01
35,57,67,-10,0,0020000835,2000-01
36,57,67,-10,0,0020000835,2000-01
37,57,67,-10,0,0020000835,2000-01
38,57,67,-10,0,0020000835,2000-01
39,57,69,-12,0,0020000835,2000-01
40,59,69,-10,0,0020000835,2000-01
41,59,71,-12,0,0020000835,2000-01
42,59,73,-14,0,0020000835,2000-01
43,63,75,-12,0,0020000835,2000-01
44,63,79,-16,0,0020000835,2000-01
45,63,83,-20,0,0020000835,2000-01
46,65,85,-20,0,0020000835,2000-01
47,67,87,-20,0,0020000835,2000-01
48,71,91,-20,0,0020000835,2000-01
49,71,91,-20,0,0020000835,2000-01
1,0,4,-4,0,0020001081,2000-01
2,0,6,-6,0,0020001081,2000-01
3,2,8,-6,0,0020001081,2000-01
4,4,8,-4,0,0020001081,2000-01
5,5,8,-3,0,0020001081,2000-01
6,5,10,-5,0,0020001081,2000-01
7,10,10,0,0,0020001081,2000-01
8,14,10,4,0,0020001081,2000-01
9,16,12,4,0,0020001081,2000-01
10,16,16,0,0,0020001081,2000-01
11,18,16,2,0,0020001081,2000-01
12,20,19,1,0,0020001081,2000-01
13,22,21,1,0,0020001081,2000-01
14,24,21,3,0,0020001081,2000-01
15,26,23,3,0,0020001081,2000-01
16,26,27,-1,0,0020001081,2000-01
17,28,27,1,0,0020001081,2000-01
18,30,27,3,0,0020001081,2000-01
19,31,29,2,0,0020001081,2000-01
20,31,32,-1,0,0020001081,2000-01
21,33,32,1,0,0020001081,2000-01
22,35,32,3,0,0020001081,2000-01
23,37,34,3,0,0020001081,2000-01
24,39,36,3,0,0020001081,2000-01
25,43,36,7,0,0020001081,2000-01
26,43,38,5,0,0020001081,2000-01
27,43,40,3,0,0020001081,2000-01
28,43,44,-1,0,0020001081,2000-01
29,43,48,-5,0,0020001081,2000-01
30,43,50,-7,0,0020001081,2000-01
31,43,50,-7,0,0020001081,2000-01
32,43,53,-10,0,0020001081,2000-01
33,43,57,-14,0,0020001081,2000-01
34,47,59,-12,0,0020001081,2000-01
35,49,63,-14,0,0020001081,2000-01
36,51,63,-12,0,0020001081,2000-01
37,51,63,-12,0,0020001081,2000-01
38,53,63,-10,0,0020001081,2000-01
39,56,66,-10,0,0020001081,2000-01
40,60,66,-6,0,0020001081,2000-01
41,62,69,-7,0,0020001081,2000-01
42,63,69,-6,0,0020001081,2000-01
43,65,71,-6,0,0020001081,2000-01
44,67,71,-4,0,0020001081,2000-01
45,69,75,-6,0,0020001081,2000-01
46,69,77,-8,0,0020001081,2000-01
47,73,80,-7,0,0020001081,2000-01
48,78,86,-8,0,0020001081,2000-01
49,78,86,-8,0,0020001081,2000-01
1,2,2,0,1,0020900750,2009-10
2,3,4,-1,1,0020900750,2009-10
3,4,6,-2,1,0020900750,2009-10
4,8,8,0,1,0020900750,2009-10
5,9,12,-3,1,0020900750,2009-10
6,13,12,1,1,0020900750,2009-10
7,15,14,1,1,0020900750,2009-10
8,19,16,3,1,0020900750,2009-10
9,21,20,1,1,0020900750,2009-10
10,21,20,1,1,0020900750,2009-10
11,21,24,-3,1,0020900750,2009-10
12,26,29,-3,1,0020900750,2009-10
13,26,32,-6,1,0020900750,2009-10
14,28,34,-6,1,0020900750,2009-10
15,28,37,-9,1,0020900750,2009-10
16,30,39,-9,1,0020900750,2009-10
17,30,39,-9,1,0020900750,2009-10
18,30,39,-9,1,0020900750,2009-10
19,35,39,-4,1,0020900750,2009-10
20,37,41,-4,1,0020900750,2009-10
21,41,44,-3,1,0020900750,2009-10
22,43,44,-1,1,0020900750,2009-10
23,48,46,2,1,0020900750,2009-10
24,51,48,3,1,0020900750,2009-10
25,54,50,4,1,0020900750,2009-10
26,57,53,4,1,0020900750,2009-10
27,61,53,8,1,0020900750,2009-10
28,61,53,8,1,0020900750,2009-10
29,63,55,8,1,0020900750,2009-10
30,63,55,8,1,0020900750,2009-10
31,65,55,10,1,0020900750,2009-10
32,67,57,10,1,0020900750,2009-10
33,67,59,8,1,0020900750,2009-10
34,67,62,5,1,0020900750,2009-10
35,67,62,5,1,0020900750,2009-10
36,73,64,9,1,0020900750,2009-10
37,75,64,11,1,0020900750,2009-10
38,75,66,9,1,0020900750,2009-10
39,78,66,12,1,0020900750,2009-10
40,78,66,12,1,0020900750,2009-10
41,80,66,14,1,0020900750,2009-10
42,84,68,16,1,0020900750,2009-10
43,84,70,14,1,0020900750,2009-10
44,86,72,14,1,0020900750,2009-10
45,92,74,18,1,0020900750,2009-10
46,94,76,18,1,0020900750,2009-10
47,97,81,16,1,0020900750,2009-10
48,99,82,17,1,0020900750,2009-10
49,99,82,17,1,0020900750,2009-10
1,0,2,-2,0,0020601061,2006-07
2,3,4,-1,0,0020601061,2006-07
3,5,4,1,0,0020601061,2006-07
4,5,8,-3,0,0020601061,2006-07
5,7,10,-3,0,0020601061,2006-07
6,10,12,-2,0,0020601061,2006-07
7,10,14,-4,0,0020601061,2006-07
8,12,18,-6,0,0020601061,2006-07
9,14,19,-5,0,0020601061,2006-07
10,16,21,-5,0,0020601061,2006-07
11,20,22,-2,0,0020601061,2006-07
12,20,24,-4,0,0020601061,2006-07
13,20,25,-5,0,0020601061,2006-07
14,21,27,-6,0,0020601061,2006-07
15,23,27,-4,0,0020601061,2006-07
16,24,27,-3,0,0020601061,2006-07
17,25,29,-4,0,0020601061,2006-07
18,29,29,0,0,0020601061,2006-07
19,29,34,-5,0,0020601061,2006-07
20,29,36,-7,0,0020601061,2006-07
21,32,40,-8,0,0020601061,2006-07
22,32,44,-12,0,0020601061,2006-07
23,34,46,-12,0,0020601061,2006-07
24,38,50,-12,0,0020601061,2006-07
25,42,52,-10,0,0020601061,2006-07
26,42,54,-12,0,0020601061,2006-07
27,46,54,-8,0,0020601061,2006-07
28,48,54,-6,0,0020601061,2006-07
29,48,57,-9,0,0020601061,2006-07
30,52,59,-7,0,0020601061,2006-07
31,52,59,-7,0,0020601061,2006-07
32,54,59,-5,0,0020601061,2006-07
33,56,61,-5,0,0020601061,2006-07
34,56,64,-8,0,0020601061,2006-07
35,58,66,-8,0,0020601061,2006-07
36,63,66,-3,0,0020601061,2006-07
37,63,68,-5,0,0020601061,2006-07
38,65,70,-5,0,0020601061,2006-07
39,67,70,-3,0,0020601061,2006-07
40,69,70,-1,0,0020601061,2006-07
41,71,70,1,0,0020601061,2006-07
42,73,72,1,0,0020601061,2006-07
43,75,72,3,0,0020601061,2006-07
44,77,74,3,0,0020601061,2006-07
45,77,77,0,0,0020601061,2006-07
46,81,77,4,0,0020601061,2006-07
47,81,79,2,0,0020601061,2006-07
48,83,83,0,0,0020601061,2006-07
49,83,83,0,0,0020601061,2006-07
50,83,83,0,0,0020601061,2006-07
51,83,83,0,0,0020601061,2006-07
52,83,83,0,0,0020601061,2006-07
53,83,83,0,0,0020601061,2006-07
54,83,83,0,0,0020601061,2006-07
55,83,83,0,0,0020601061,2006-07
56,84,85,-1,0,0020601061,2006-07
57,84,87,-3,0,0020601061,2006-07
58,86,87,-1,0,0020601061,2006-07
59,88,87,1,0,0020601061,2006-07
60,90,90,0,0,0020601061,2006-07
61,90,90,0,0,0020601061,2006-07
62,90,90,0,0,0020601061,2006-07
63,90,90,0,0,0020601061,2006-07
64,90,90,0,0,0020601061,2006-07
65,90,90,0,0,0020601061,2006-07
66,90,90,0,0,0020601061,2006-07
67,90,90,0,0,0020601061,2006-07
68,92,90,2,0,0020601061,2006-07
69,92,92,0,0,0020601061,2006-07
70,92,95,-3,0,0020601061,2006-07
71,94,97,-3,0,0020601061,2006-07
72,96,105,-9,0,0020601061,2006-07
73,96,105,-9,0,0020601061,2006-07
1,0,0,0,1,0021800667,2018-19
2,0,3,-3,1,0021800667,2018-19
3,0,7,-7,1,0021800667,2018-19
4,5,7,-2,1,0021800667,2018-19
5,8,11,-3,1,0021800667,2018-19
6,12,15,-3,1,0021800667,2018-19
7,15,18,-3,1,0021800667,2018-19
8,20,18,2,1,0021800667,2018-19
9,22,21,1,1,0021800667,2018-19
10,22,21,1,1,0021800667,2018-19
11,24,21,3,1,0021800667,2018-19
12,28,25,3,1,0021800667,2018-19
13,28,29,-1,1,0021800667,2018-19
14,31,29,2,1,0021800667,2018-19
15,31,32,-1,1,0021800667,2018-19
16,31,32,-1,1,0021800667,2018-19
17,36,34,2,1,0021800667,2018-19
18,36,36,0,1,0021800667,2018-19
19,39,36,3,1,0021800667,2018-19
20,41,40,1,1,0021800667,2018-19
21,43,40,3,1,0021800667,2018-19
22,49,43,6,1,0021800667,2018-19
23,51,46,5,1,0021800667,2018-19
24,54,48,6,1,0021800667,2018-19
25,56,51,5,1,0021800667,2018-19
26,58,51,7,1,0021800667,2018-19
27,61,55,6,1,0021800667,2018-19
28,66,55,11,1,0021800667,2018-19
29,69,59,10,1,0021800667,2018-19
30,71,65,6,1,0021800667,2018-19
31,73,65,8,1,0021800667,2018-19
32,77,67,10,1,0021800667,2018-19
33,77,69,8,1,0021800667,2018-19
34,79,69,10,1,0021800667,2018-19
35,79,71,8,1,0021800667,2018-19
36,86,71,15,1,0021800667,2018-19
37,91,73,18,1,0021800667,2018-19
38,91,77,14,1,0021800667,2018-19
39,91,79,12,1,0021800667,2018-19
40,91,81,10,1,0021800667,2018-19
41,97,83,14,1,0021800667,2018-19
42,100,85,15,1,0021800667,2018-19
43,102,87,15,1,0021800667,2018-19
44,104,87,17,1,0021800667,2018-19
45,108,91,17,1,0021800667,2018-19
46,110,94,16,1,0021800667,2018-19
47,114,94,20,1,0021800667,2018-19
48,120,96,24,1,0021800667,2018-19
49,120,96,24,1,0021800667,2018-19
1,2,0,2,0,0020400801,2004-05
2,6,0,6,0,0020400801,2004-05
3,6,2,4,0,0020400801,2004-05
4,9,8,1,0,0020400801,2004-05
5,12,10,2,0,0020400801,2004-05
6,14,12,2,0,0020400801,2004-05
7,16,14,2,0,0020400801,2004-05
8,18,17,1,0,0020400801,2004-05
9,22,17,5,0,0020400801,2004-05
10,27,23,4,0,0020400801,2004-05
11,29,28,1,0,0020400801,2004-05
12,31,28,3,0,0020400801,2004-05
13,34,28,6,0,0020400801,2004-05
14,35,31,4,0,0020400801,2004-05
15,37,31,6,0,0020400801,2004-05
16,39,33,6,0,0020400801,2004-05
17,45,35,10,0,0020400801,2004-05
18,48,40,8,0,0020400801,2004-05
19,48,43,5,0,0020400801,2004-05
20,52,45,7,0,0020400801,2004-05
21,54,49,5,0,0020400801,2004-05
22,54,51,3,0,0020400801,2004-05
23,58,53,5,0,0020400801,2004-05
24,58,55,3,0,0020400801,2004-05
25,63,55,8,0,0020400801,2004-05
26,65,55,10,0,0020400801,2004-05
27,65,58,7,0,0020400801,2004-05
28,65,62,3,0,0020400801,2004-05
29,65,64,1,0,0020400801,2004-05
30,68,67,1,0,0020400801,2004-05
31,70,70,0,0,0020400801,2004-05
32,73,70,3,0,0020400801,2004-05
33,73,72,1,0,0020400801,2004-05
34,77,74,3,0,0020400801,2004-05
35,79,79,0,0,0020400801,2004-05
36,79,79,0,0,0020400801,2004-05
37,79,85,-6,0,0020400801,2004-05
38,79,85,-6,0,0020400801,2004-05
39,81,89,-8,0,0020400801,2004-05
40,84,89,-5,0,0020400801,2004-05
41,86,93,-7,0,0020400801,2004-05
42,86,95,-9,0,0020400801,2004-05
43,88,97,-9,0,0020400801,2004-05
44,91,102,-11,0,0020400801,2004-05
45,93,105,-12,0,0020400801,2004-05
46,97,110,-13,0,0020400801,2004-05
47,97,111,-14,0,0020400801,2004-05
48,101,113,-12,0,0020400801,2004-05
49,101,113,-12,0,0020400801,2004-05
1,0,0,0,0,0021600845,2016-17
2,5,2,3,0,0021600845,2016-17
3,10,2,8,0,0021600845,2016-17
4,16,2,14,0,0021600845,2016-17
5,18,6,12,0,0021600845,2016-17
6,22,11,11,0,0021600845,2016-17
7,24,14,10,0,0021600845,2016-17
8,28,16,12,0,0021600845,2016-17
9,34,18,16,0,0021600845,2016-17
10,37,23,14,0,0021600845,2016-17
11,39,23,16,0,0021600845,2016-17
12,39,27,12,0,0021600845,2016-17
13,42,27,15,0,0021600845,2016-17
14,44,29,15,0,0021600845,2016-17
15,47,32,15,0,0021600845,2016-17
16,49,36,13,0,0021600845,2016-17
17,52,38,14,0,0021600845,2016-17
18,54,38,16,0,0021600845,2016-17
19,54,42,12,0,0021600845,2016-17
20,54,44,10,0,0021600845,2016-17
21,56,49,7,0,0021600845,2016-17
22,56,51,5,0,0021600845,2016-17
23,58,54,4,0,0021600845,2016-17
24,60,62,-2,0,0021600845,2016-17
25,60,66,-6,0,0021600845,2016-17
26,62,70,-8,0,0021600845,2016-17
27,64,70,-6,0,0021600845,2016-17
28,64,72,-8,0,0021600845,2016-17
29,66,72,-6,0,0021600845,2016-17
30,71,74,-3,0,0021600845,2016-17
31,71,76,-5,0,0021600845,2016-17
32,71,78,-7,0,0021600845,2016-17
33,76,82,-6,0,0021600845,2016-17
34,76,85,-9,0,0021600845,2016-17
35,76,85,-9,0,0021600845,2016-17
36,80,85,-5,0,0021600845,2016-17
37,82,90,-8,0,0021600845,2016-17
38,82,92,-10,0,0021600845,2016-17
39,82,94,-12,0,0021600845,2016-17
40,87,94,-7,0,0021600845,2016-17
41,87,96,-9,0,0021600845,2016-17
42,92,99,-7,0,0021600845,2016-17
43,94,105,-11,0,0021600845,2016-17
44,96,111,-15,0,0021600845,2016-17
45,99,111,-12,0,0021600845,2016-17
46,101,114,-13,0,0021600845,2016-17
47,101,116,-15,0,0021600845,2016-17
48,105,116,-11,0,0021600845,2016-17
49,105,116,-11,0,0021600845,2016-17
1,2,2,0,1,0029800095,1998-99
2,6,6,0,1,0029800095,1998-99
3,6,8,-2,1,0029800095,1998-99
4,8,10,-2,1,0029800095,1998-99
5,10,13,-3,1,0029800095,1998-99
6,14,13,1,1,0029800095,1998-99
7,14,15,-1,1,0029800095,1998-99
8,14,20,-6,1,0029800095,1998-99
9,16,20,-4,1,0029800095,1998-99
10,16,22,-6,1,0029800095,1998-99
11,18,22,-4,1,0029800095,1998-99
12,18,24,-6,1,0029800095,1998-99
13,20,26,-6,1,0029800095,1998-99
14,22,29,-7,1,0029800095,1998-99
15,22,31,-9,1,0029800095,1998-99
16,22,34,-12,1,0029800095,1998-99
17,24,34,-10,1,0029800095,1998-99
18,24,36,-12,1,0029800095,1998-99
19,26,38,-12,1,0029800095,1998-99
20,29,39,-10,1,0029800095,1998-99
21,34,42,-8,1,0029800095,1998-99
22,36,45,-9,1,0029800095,1998-99
23,37,45,-8,1,0029800095,1998-99
24,37,49,-12,1,0029800095,1998-99
25,39,49,-10,1,0029800095,1998-99
26,39,49,-10,1,0029800095,1998-99
27,41,51,-10,1,0029800095,1998-99
28,43,51,-8,1,0029800095,1998-99
29,46,53,-7,1,0029800095,1998-99
30,46,55,-9,1,0029800095,1998-99
31,48,55,-7,1,0029800095,1998-99
32,50,55,-5,1,0029800095,1998-99
33,50,57,-7,1,0029800095,1998-99
34,51,61,-10,1,0029800095,1998-99
35,51,66,-15,1,0029800095,1998-99
36,55,68,-13,1,0029800095,1998-99
37,57,68,-11,1,0029800095,1998-99
38,59,68,-9,1,0029800095,1998-99
39,61,68,-7,1,0029800095,1998-99
40,61,69,-8,1,0029800095,1998-99
41,65,72,-7,1,0029800095,1998-99
42,68,72,-4,1,0029800095,1998-99
43,70,73,-3,1,0029800095,1998-99
44,73,73,0,1,0029800095,1998-99
45,75,75,0,1,0029800095,1998-99
46,79,76,3,1,0029800095,1998-99
47,79,76,3,1,0029800095,1998-99
48,79,76,3,1,0029800095,1998-99
49,79,76,3,1,0029800095,1998-99
1,2,4,-2,1,0029800548,1998-99
2,6,6,0,1,0029800548,1998-99
3,8,11,-3,1,0029800548,1998-99
4,12,11,1,1,0029800548,1998-99
5,14,15,-1,1,0029800548,1998-99
6,16,19,-3,1,0029800548,1998-99
7,18,21,-3,1,0029800548,1998-99
8,20,23,-3,1,0029800548,1998-99
9,22,23,-1,1,0029800548,1998-99
10,24,23,1,1,0029800548,1998-99
11,26,23,3,1,0029800548,1998-99
12,26,26,0,1,0029800548,1998-99
13,26,29,-3,1,0029800548,1998-99
14,26,31,-5,1,0029800548,1998-99
15,30,33,-3,1,0029800548,1998-99
16,33,33,0,1,0029800548,1998-99
17,36,33,3,1,0029800548,1998-99
18,36,33,3,1,0029800548,1998-99
19,38,33,5,1,0029800548,1998-99
20,42,33,9,1,0029800548,1998-99
21,44,35,9,1,0029800548,1998-99
22,47,38,9,1,0029800548,1998-99
23,47,41,6,1,0029800548,1998-99
24,49,44,5,1,0029800548,1998-99
25,49,44,5,1,0029800548,1998-99
26,51,46,5,1,0029800548,1998-99
27,53,49,4,1,0029800548,1998-99
28,55,51,4,1,0029800548,1998-99
29,57,51,6,1,0029800548,1998-99
30,57,53,4,1,0029800548,1998-99
31,57,54,3,1,0029800548,1998-99
32,57,55,2,1,0029800548,1998-99
33,59,57,2,1,0029800548,1998-99
34,61,57,4,1,0029800548,1998-99
35,63,60,3,1,0029800548,1998-99
36,67,60,7,1,0029800548,1998-99
37,69,60,9,1,0029800548,1998-99
38,69,60,9,1,0029800548,1998-99
39,69,60,9,1,0029800548,1998-99
40,69,62,7,1,0029800548,1998-99
41,71,64,7,1,0029800548,1998-99
42,71,66,5,1,0029800548,1998-99
43,72,66,6,1,0029800548,1998-99
44,74,66,8,1,0029800548,1998-99
45,77,67,10,1,0029800548,1998-99
46,79,71,8,1,0029800548,1998-99
47,82,71,11,1,0029800548,1998-99
48,89,81,8,1,0029800548,1998-99
49,89,81,8,1,0029800548,1998-99
1,1,2,-1,0,0029700846,1997-98
2,1,4,-3,0,0029700846,1997-98
3,1,9,-8,0,0029700846,1997-98
4,3,12,-9,0,0029700846,1997-98
5,7,12,-5,0,0029700846,1997-98
6,11,14,-3,0,0029700846,1997-98
7,13,16,-3,0,0029700846,1997-98
8,17,18,-1,0,0029700846,1997-98
9,21,18,3,0,0029700846,1997-98
10,23,22,1,0,0029700846,1997-98
11,26,25,1,0,0029700846,1997-98
12,27,27,0,0,0029700846,1997-98
13,27,27,0,0,0029700846,1997-98
14,31,27,4,0,0029700846,1997-98
15,33,31,2,0,0029700846,1997-98
16,36,34,2,0,0029700846,1997-98
17,36,37,-1,0,0029700846,1997-98
18,36,38,-2,0,0029700846,1997-98
19,36,44,-8,0,0029700846,1997-98
20,39,44,-5,0,0029700846,1997-98
21,41,46,-5,0,0029700846,1997-98
22,45,48,-3,0,0029700846,1997-98
23,50,50,0,0,0029700846,1997-98
24,50,53,-3,0,0029700846,1997-98
25,52,55,-3,0,0029700846,1997-98
26,54,59,-5,0,0029700846,1997-98
27,54,63,-9,0,0029700846,1997-98
28,57,64,-7,0,0029700846,1997-98
29,59,66,-7,0,0029700846,1997-98
30,61,70,-9,0,0029700846,1997-98
31,66,72,-6,0,0029700846,1997-98
32,71,72,-1,0,0029700846,1997-98
33,75,76,-1,0,0029700846,1997-98
34,77,80,-3,0,0029700846,1997-98
35,79,80,-1,0,0029700846,1997-98
36,81,82,-1,0,0029700846,1997-98
37,85,84,1,0,0029700846,1997-98
38,85,84,1,0,0029700846,1997-98
39,87,84,3,0,0029700846,1997-98
40,89,87,2,0,0029700846,1997-98
41,91,89,2,0,0029700846,1997-98
42,91,93,-2,0,0029700846,1997-98
43,91,96,-5,0,0029700846,1997-98
44,93,100,-7,0,0029700846,1997-98
45,97,102,-5,0,0029700846,1997-98
46,102,104,-2,0,0029700846,1997-98
47,102,108,-6,0,0029700846,1997-98
48,102,112,-10,0,0029700846,1997-98
49,102,112,-10,0,0029700846,1997-98
1,2,0,2,0,0020100783,2001-02
2,2,4,-2,0,0020100783,2001-02
3,7,6,1,0,0020100783,2001-02
4,9,8,1,0,0020100783,2001-02
5,9,10,-1,0,0020100783,2001-02
6,11,13,-2,0,0020100783,2001-02
7,13,16,-3,0,0020100783,2001-02
8,17,18,-1,0,0020100783,2001-02
9,19,20,-1,0,0020100783,2001-02
10,19,22,-3,0,0020100783,2001-02
11,23,22,1,0,0020100783,2001-02
12,25,24,1,0,0020100783,2001-02
13,26,24,2,0,0020100783,2001-02
14,29,28,1,0,0020100783,2001-02
15,31,31,0,0,0020100783,2001-02
16,31,33,-2,0,0020100783,2001-02
17,33,33,0,0,0020100783,2001-02
18,36,35,1,0,0020100783,2001-02
19,41,36,5,0,0020100783,2001-02
20,43,39,4,0,0020100783,2001-02
21,43,42,1,0,0020100783,2001-02
22,45,44,1,0,0020100783,2001-02
23,47,48,-1,0,0020100783,2001-02
24,52,48,4,0,0020100783,2001-02
25,52,48,4,0,0020100783,2001-02
26,54,50,4,0,0020100783,2001-02
27,58,51,7,0,0020100783,2001-02
28,58,57,1,0,0020100783,2001-02
29,60,57,3,0,0020100783,2001-02
30,64,60,4,0,0020100783,2001-02
31,64,60,4,0,0020100783,2001-02
32,64,66,-2,0,0020100783,2001-02
33,64,69,-5,0,0020100783,2001-02
34,64,71,-7,0,0020100783,2001-02
35,65,73,-8,0,0020100783,2001-02
36,67,75,-8,0,0020100783,2001-02
37,69,79,-10,0,0020100783,2001-02
38,72,81,-9,0,0020100783,2001-02
39,75,85,-10,0,0020100783,2001-02
40,75,86,-11,0,0020100783,2001-02
41,78,91,-13,0,0020100783,2001-02
42,80,91,-11,0,0020100783,2001-02
43,81,93,-12,0,0020100783,2001-02
44,86,96,-10,0,0020100783,2001-02
45,88,101,-13,0,0020100783,2001-02
46,91,105,-14,0,0020100783,2001-02
47,91,110,-19,0,0020100783,2001-02
48,97,111,-14,0,0020100783,2001-02
49,97,111,-14,0,0020100783,2001-02
1,2,0,2,1,0029700014,1997-98
2,4,4,0,1,0029700014,1997-98
3,8,6,2,1,0029700014,1997-98
4,10,8,2,1,0029700014,1997-98
5,14,10,4,1,0029700014,1997-98
6,16,10,6,1,0029700014,1997-98
7,18,12,6,1,0029700014,1997-98
8,20,12,8,1,0029700014,1997-98
9,22,14,8,1,0029700014,1997-98
10,24,14,10,1,0029700014,1997-98
11,26,18,8,1,0029700014,1997-98
12,26,18,8,1,0029700014,1997-98
13,26,20,6,1,0029700014,1997-98
14,28,22,6,1,0029700014,1997-98
15,28,22,6,1,0029700014,1997-98
16,30,25,5,1,0029700014,1997-98
17,30,29,1,1,0029700014,1997-98
18,34,29,5,1,0029700014,1997-98
19,34,31,3,1,0029700014,1997-98
20,34,36,-2,1,0029700014,1997-98
21,38,38,0,1,0029700014,1997-98
22,39,40,-1,1,0029700014,1997-98
23,41,42,-1,1,0029700014,1997-98
24,43,45,-2,1,0029700014,1997-98
25,45,47,-2,1,0029700014,1997-98
26,45,49,-4,1,0029700014,1997-98
27,47,50,-3,1,0029700014,1997-98
28,49,53,-4,1,0029700014,1997-98
29,55,55,0,1,0029700014,1997-98
30,56,58,-2,1,0029700014,1997-98
31,58,60,-2,1,0029700014,1997-98
32,65,60,5,1,0029700014,1997-98
33,65,60,5,1,0029700014,1997-98
34,69,60,9,1,0029700014,1997-98
35,69,64,5,1,0029700014,1997-98
36,74,66,8,1,0029700014,1997-98
37,74,70,4,1,0029700014,1997-98
38,76,71,5,1,0029700014,1997-98
39,78,71,7,1,0029700014,1997-98
40,78,73,5,1,0029700014,1997-98
41,78,77,1,1,0029700014,1997-98
42,79,77,2,1,0029700014,1997-98
43,81,79,2,1,0029700014,1997-98
44,81,81,0,1,0029700014,1997-98
45,84,83,1,1,0029700014,1997-98
46,86,83,3,1,0029700014,1997-98
47,86,83,3,1,0029700014,1997-98
48,90,88,2,1,0029700014,1997-98
49,90,88,2,1,0029700014,1997-98
1,4,0,4,1,0021000259,2010-11
2,6,2,4,1,0021000259,2010-11
3,6,5,1,1,0021000259,2010-11
4,6,9,-3,1,0021000259,2010-11
5,6,9,-3,1,0021000259,2010-11
6,6,11,-5,1,0021000259,2010-11
7,9,13,-4,1,0021000259,2010-11
8,13,14,-1,1,0021000259,2010-11
9,16,16,0,1,0021000259,2010-11
10,18,18,0,1,0021000259,2010-11
11,19,22,-3,1,0021000259,2010-11
12,22,23,-1,1,0021000259,2010-11
13,22,25,-3,1,0021000259,2010-11
14,26,25,1,1,0021000259,2010-11
15,29,27,2,1,0021000259,2010-11
16,32,31,1,1,0021000259,2010-11
17,35,33,2,1,0021000259,2010-11
18,37,36,1,1,0021000259,2010-11
19,39,38,1,1,0021000259,2010-11
20,42,45,-3,1,0021000259,2010-11
21,47,47,0,1,0021000259,2010-11
22,49,48,1,1,0021000259,2010-11
23,49,50,-1,1,0021000259,2010-11
24,52,52,0,1,0021000259,2010-11
25,54,52,2,1,0021000259,2010-11
26,57,52,5,1,0021000259,2010-11
27,61,54,7,1,0021000259,2010-11
28,63,54,9,1,0021000259,2010-11
29,69,56,13,1,0021000259,2010-11
30,71,58,13,1,0021000259,2010-11
31,74,60,14,1,0021000259,2010-11
32,76,60,16,1,0021000259,2010-11
33,78,60,18,1,0021000259,2010-11
34,80,62,18,1,0021000259,2010-11
35,80,65,15,1,0021000259,2010-11
36,80,69,11,1,0021000259,2010-11
37,82,71,11,1,0021000259,2010-11
38,85,75,10,1,0021000259,2010-11
39,87,75,12,1,0021000259,2010-11
40,87,79,8,1,0021000259,2010-11
41,90,81,9,1,0021000259,2010-11
42,92,83,9,1,0021000259,2010-11
43,94,83,11,1,0021000259,2010-11
44,96,86,10,1,0021000259,2010-11
45,99,88,11,1,0021000259,2010-11
46,99,90,9,1,0021000259,2010-11
47,101,93,8,1,0021000259,2010-11
48,107,98,9,1,0021000259,2010-11
49,107,98,9,1,0021000259,2010-11
1,2,0,2,0,0020400197,2004-05
2,3,0,3,0,0020400197,2004-05
3,6,0,6,0,0020400197,2004-05
4,11,4,7,0,0020400197,2004-05
5,13,4,9,0,0020400197,2004-05
6,15,7,8,0,0020400197,2004-05
7,17,11,6,0,0020400197,2004-05
8,19,13,6,0,0020400197,2004-05
9,19,15,4,0,0020400197,2004-05
10,21,17,4,0,0020400197,2004-05
11,21,22,-1,0,0020400197,2004-05
12,21,22,-1,0,0020400197,2004-05
13,24,24,0,0,0020400197,2004-05
14,24,26,-2,0,0020400197,2004-05
15,29,28,1,0,0020400197,2004-05
16,30,33,-3,0,0020400197,2004-05
17,30,33,-3,0,0020400197,2004-05
18,32,38,-6,0,0020400197,2004-05
19,36,41,-5,0,0020400197,2004-05
20,37,44,-7,0,0020400197,2004-05
21,41,46,-5,0,0020400197,2004-05
22,43,48,-5,0,0020400197,2004-05
23,45,51,-6,0,0020400197,2004-05
24,46,55,-9,0,0020400197,2004-05
25,50,55,-5,0,0020400197,2004-05
26,52,57,-5,0,0020400197,2004-05
27,52,59,-7,0,0020400197,2004-05
28,54,59,-5,0,0020400197,2004-05
29,56,62,-6,0,0020400197,2004-05
30,56,62,-6,0,0020400197,2004-05
31,56,66,-10,0,0020400197,2004-05
32,61,66,-5,0,0020400197,2004-05
33,63,68,-5,0,0020400197,2004-05
34,65,70,-5,0,0020400197,2004-05
35,67,73,-6,0,0020400197,2004-05
36,68,77,-9,0,0020400197,2004-05
37,68,79,-11,0,0020400197,2004-05
38,70,81,-11,0,0020400197,2004-05
39,75,83,-8,0,0020400197,2004-05
40,75,87,-12,0,0020400197,2004-05
41,80,89,-9,0,0020400197,2004-05
42,80,89,-9,0,0020400197,2004-05
43,83,91,-8,0,0020400197,2004-05
44,86,93,-7,0,0020400197,2004-05
45,89,93,-4,0,0020400197,2004-05
46,89,98,-9,0,0020400197,2004-05
47,92,100,-8,0,0020400197,2004-05
48,95,103,-8,0,0020400197,2004-05
49,95,103,-8,0,0020400197,2004-05
1,2,2,0,0,0029700779,1997-98
2,4,4,0,0,0029700779,1997-98
3,8,4,4,0,0029700779,1997-98
4,8,8,0,0,0029700779,1997-98
5,10,8,2,0,0029700779,1997-98
6,13,10,3,0,0029700779,1997-98
7,17,12,5,0,0029700779,1997-98
8,23,14,9,0,0029700779,1997-98
9,23,20,3,0,0029700779,1997-98
10,23,20,3,0,0029700779,1997-98
11,29,20,9,0,0029700779,1997-98
12,29,22,7,0,0029700779,1997-98
13,31,22,9,0,0029700779,1997-98
14,31,24,7,0,0029700779,1997-98
15,33,26,7,0,0029700779,1997-98
16,35,28,7,0,0029700779,1997-98
17,35,29,6,0,0029700779,1997-98
18,38,33,5,0,0029700779,1997-98
19,40,37,3,0,0029700779,1997-98
20,42,37,5,0,0029700779,1997-98
21,44,39,5,0,0029700779,1997-98
22,44,42,2,0,0029700779,1997-98
23,46,44,2,0,0029700779,1997-98
24,46,44,2,0,0029700779,1997-98
25,48,46,2,0,0029700779,1997-98
26,48,48,0,0,0029700779,1997-98
27,48,48,0,0,0029700779,1997-98
28,50,50,0,0,0029700779,1997-98
29,52,52,0,0,0029700779,1997-98
30,54,56,-2,0,0029700779,1997-98
31,56,56,0,0,0029700779,1997-98
32,58,58,0,0,0029700779,1997-98
33,64,58,6,0,0029700779,1997-98
34,66,62,4,0,0029700779,1997-98
35,66,64,2,0,0029700779,1997-98
36,66,68,-2,0,0029700779,1997-98
37,71,68,3,0,0029700779,1997-98
38,71,70,1,0,0029700779,1997-98
39,71,72,-1,0,0029700779,1997-98
40,71,74,-3,0,0029700779,1997-98
41,72,78,-6,0,0029700779,1997-98
42,73,78,-5,0,0029700779,1997-98
43,75,80,-5,0,0029700779,1997-98
44,77,84,-7,0,0029700779,1997-98
45,79,85,-6,0,0029700779,1997-98
46,79,90,-11,0,0029700779,1997-98
47,79,92,-13,0,0029700779,1997-98
48,79,97,-18,0,0029700779,1997-98
49,79,97,-18,0,0029700779,1997-98
1,2,2,0,0,0020100565,2001-02
2,2,5,-3,0,0020100565,2001-02
3,3,10,-7,0,0020100565,2001-02
4,3,12,-9,0,0020100565,2001-02
5,3,14,-11,0,0020100565,2001-02
6,3,17,-14,0,0020100565,2001-02
7,7,20,-13,0,0020100565,2001-02
8,10,22,-12,0,0020100565,2001-02
9,12,23,-11,0,0020100565,2001-02
10,12,25,-13,0,0020100565,2001-02
11,12,27,-15,0,0020100565,2001-02
12,16,32,-16,0,0020100565,2001-02
13,17,32,-15,0,0020100565,2001-02
14,20,34,-14,0,0020100565,2001-02
15,23,38,-15,0,0020100565,2001-02
16,26,40,-14,0,0020100565,2001-02
17,27,43,-16,0,0020100565,2001-02
18,29,46,-17,0,0020100565,2001-02
19,33,48,-15,0,0020100565,2001-02
20,37,50,-13,0,0020100565,2001-02
21,40,52,-12,0,0020100565,2001-02
22,40,54,-14,0,0020100565,2001-02
23,44,58,-14,0,0020100565,2001-02
24,44,58,-14,0,0020100565,2001-02
25,48,61,-13,0,0020100565,2001-02
26,50,61,-11,0,0020100565,2001-02
27,50,65,-15,0,0020100565,2001-02
28,50,67,-17,0,0020100565,2001-02
29,54,70,-16,0,0020100565,2001-02
30,54,72,-18,0,0020100565,2001-02
31,58,72,-14,0,0020100565,2001-02
32,60,72,-12,0,0020100565,2001-02
33,60,76,-16,0,0020100565,2001-02
34,60,78,-18,0,0020100565,2001-02
35,63,78,-15,0,0020100565,2001-02
36,67,81,-14,0,0020100565,2001-02
37,69,81,-12,0,0020100565,2001-02
38,72,81,-9,0,0020100565,2001-02
39,76,84,-8,0,0020100565,2001-02
40,76,88,-12,0,0020100565,2001-02
41,76,90,-14,0,0020100565,2001-02
42,78,93,-15,0,0020100565,2001-02
43,80,95,-15,0,0020100565,2001-02
44,82,97,-15,0,0020100565,2001-02
45,86,99,-13,0,0020100565,2001-02
46,92,99,-7,0,0020100565,2001-02
47,97,101,-4,0,0020100565,2001-02
48,103,106,-3,0,0020100565,2001-02
49,103,106,-3,0,0020100565,2001-02
1,0,3,-3,0,0021200367,2012-13
2,2,3,-1,0,0021200367,2012-13
3,5,3,2,0,0021200367,2012-13
4,7,7,0,0,0021200367,2012-13
5,9,10,-1,0,0021200367,2012-13
6,12,10,2,0,0021200367,2012-13
7,14,10,4,0,0021200367,2012-13
8,14,13,1,0,0021200367,2012-13
9,14,17,-3,0,0021200367,2012-13
10,17,19,-2,0,0021200367,2012-13
11,21,19,2,0,0021200367,2012-13
12,23,26,-3,0,0021200367,2012-13
13,26,28,-2,0,0021200367,2012-13
14,30,30,0,0,0021200367,2012-13
15,33,33,0,0,0021200367,2012-13
16,33,37,-4,0,0021200367,2012-13
17,36,37,-1,0,0021200367,2012-13
18,39,37,2,0,0021200367,2012-13
19,41,39,2,0,0021200367,2012-13
20,41,39,2,0,0021200367,2012-13
21,43,41,2,0,0021200367,2012-13
22,45,47,-2,0,0021200367,2012-13
23,46,50,-4,0,0021200367,2012-13
24,48,52,-4,0,0021200367,2012-13
25,53,52,1,0,0021200367,2012-13
26,55,54,1,0,0021200367,2012-13
27,55,55,0,0,0021200367,2012-13
28,57,57,0,0,0021200367,2012-13
29,59,57,2,0,0021200367,2012-13
30,61,59,2,0,0021200367,2012-13
31,61,62,-1,0,0021200367,2012-13
32,61,64,-3,0,0021200367,2012-13
33,63,66,-3,0,0021200367,2012-13
34,63,66,-3,0,0021200367,2012-13
35,65,70,-5,0,0021200367,2012-13
36,67,75,-8,0,0021200367,2012-13
37,67,75,-8,0,0021200367,2012-13
38,68,75,-7,0,0021200367,2012-13
39,68,80,-12,0,0021200367,2012-13
40,68,82,-14,0,0021200367,2012-13
41,74,84,-10,0,0021200367,2012-13
42,76,86,-10,0,0021200367,2012-13
43,78,89,-11,0,0021200367,2012-13
44,80,94,-14,0,0021200367,2012-13
45,80,94,-14,0,0021200367,2012-13
46,80,98,-18,0,0021200367,2012-13
47,84,100,-16,0,0021200367,2012-13
48,86,100,-14,0,0021200367,2012-13
49,86,100,-14,0,0021200367,2012-13
1,2,0,2,0,0029600919,1996-97
2,4,0,4,0,0029600919,1996-97
3,4,2,2,0,0029600919,1996-97
4,7,2,5,0,0029600919,1996-97
5,9,6,3,0,0029600919,1996-97
6,11,6,5,0,0029600919,1996-97
7,11,7,4,0,0029600919,1996-97
8,14,9,5,0,0029600919,1996-97
9,14,14,0,0,0029600919,1996-97
10,15,19,-4,0,0029600919,1996-97
11,19,21,-2,0,0029600919,1996-97
12,19,21,-2,0,0029600919,1996-97
13,19,25,-6,0,0029600919,1996-97
14,19,27,-8,0,0029600919,1996-97
15,21,27,-6,0,0029600919,1996-97
16,21,31,-10,0,0029600919,1996-97
17,23,33,-10,0,0029600919,1996-97
18,25,35,-10,0,0029600919,1996-97
19,25,39,-14,0,0029600919,1996-97
20,29,42,-13,0,0029600919,1996-97
21,32,42,-10,0,0029600919,1996-97
22,34,42,-8,0,0029600919,1996-97
23,34,46,-12,0,0029600919,1996-97
24,34,51,-17,0,0029600919,1996-97
25,36,53,-17,0,0029600919,1996-97
26,36,57,-21,0,0029600919,1996-97
27,43,57,-14,0,0029600919,1996-97
28,46,57,-11,0,0029600919,1996-97
29,48,61,-13,0,0029600919,1996-97
30,50,63,-13,0,0029600919,1996-97
31,53,65,-12,0,0029600919,1996-97
32,57,65,-8,0,0029600919,1996-97
33,59,68,-9,0,0029600919,1996-97
34,61,71,-10,0,0029600919,1996-97
35,64,73,-9,0,0029600919,1996-97
36,70,73,-3,0,0029600919,1996-97
37,72,73,-1,0,0029600919,1996-97
38,72,75,-3,0,0029600919,1996-97
39,72,79,-7,0,0029600919,1996-97
40,74,83,-9,0,0029600919,1996-97
41,74,85,-11,0,0029600919,1996-97
42,77,85,-8,0,0029600919,1996-97
43,82,88,-6,0,0029600919,1996-97
44,82,90,-8,0,0029600919,1996-97
45,82,94,-12,0,0029600919,1996-97
46,84,94,-10,0,0029600919,1996-97
47,86,96,-10,0,0029600919,1996-97
48,92,103,-11,0,0029600919,1996-97
49,92,103,-11,0,0029600919,1996-97
1,0,2,-2,1,0020900978,2009-10
2,2,4,-2,1,0020900978,2009-10
3,4,8,-4,1,0020900978,2009-10
4,6,8,-2,1,0020900978,2009-10
5,9,11,-2,1,0020900978,2009-10
6,9,16,-7,1,0020900978,2009-10
7,11,18,-7,1,0020900978,2009-10
8,13,19,-6,1,0020900978,2009-10
9,15,21,-6,1,0020900978,2009-10
10,17,24,-7,1,0020900978,2009-10
11,21,27,-6,1,0020900978,2009-10
12,24,33,-9,1,0020900978,2009-10
13,24,33,-9,1,0020900978,2009-10
14,28,35,-7,1,0020900978,2009-10
15,30,37,-7,1,0020900978,2009-10
16,30,39,-9,1,0020900978,2009-10
17,35,41,-6,1,0020900978,2009-10
18,37,45,-8,1,0020900978,2009-10
19,41,47,-6,1,0020900978,2009-10
20,42,51,-9,1,0020900978,2009-10
21,44,56,-12,1,0020900978,2009-10
22,49,59,-10,1,0020900978,2009-10
23,54,61,-7,1,0020900978,2009-10
24,57,63,-6,1,0020900978,2009-10
25,61,65,-4,1,0020900978,2009-10
26,61,67,-6,1,0020900978,2009-10
27,65,70,-5,1,0020900978,2009-10
28,65,72,-7,1,0020900978,2009-10
29,67,72,-5,1,0020900978,2009-10
30,69,72,-3,1,0020900978,2009-10
31,72,74,-2,1,0020900978,2009-10
32,74,74,0,1,0020900978,2009-10
33,75,79,-4,1,0020900978,2009-10
34,77,83,-6,1,0020900978,2009-10
35,82,85,-3,1,0020900978,2009-10
36,85,85,0,1,0020900978,2009-10
37,87,85,2,1,0020900978,2009-10
38,92,85,7,1,0020900978,2009-10
39,97,85,12,1,0020900978,2009-10
40,98,87,11,1,0020900978,2009-10
41,103,89,14,1,0020900978,2009-10
42,105,93,12,1,0020900978,2009-10
43,109,95,14,1,0020900978,2009-10
44,114,97,17,1,0020900978,2009-10
45,117,97,20,1,0020900978,2009-10
46,121,99,22,1,0020900978,2009-10
47,123,104,19,1,0020900978,2009-10
48,125,108,17,1,0020900978,2009-10
49,125,108,17,1,0020900978,2009-10
1,0,0,0,0,0020500985,2005-06
2,4,2,2,0,0020500985,2005-06
3,6,4,2,0,0020500985,2005-06
4,8,6,2,0,0020500985,2005-06
5,8,8,0,0,0020500985,2005-06
6,11,10,1,0,0020500985,2005-06
7,13,10,3,0,0020500985,2005-06
8,15,14,1,0,0020500985,2005-06
9,17,14,3,0,0020500985,2005-06
10,19,16,3,0,0020500985,2005-06
11,21,16,5,0,0020500985,2005-06
12,25,16,9,0,0020500985,2005-06
13,25,16,9,0,0020500985,2005-06
14,28,22,6,0,0020500985,2005-06
15,30,22,8,0,0020500985,2005-06
16,32,24,8,0,0020500985,2005-06
17,32,26,6,0,0020500985,2005-06
18,32,26,6,0,0020500985,2005-06
19,36,28,8,0,0020500985,2005-06
20,38,30,8,0,0020500985,2005-06
21,40,32,8,0,0020500985,2005-06
22,40,32,8,0,0020500985,2005-06
23,44,32,12,0,0020500985,2005-06
24,45,34,11,0,0020500985,2005-06
25,47,36,11,0,0020500985,2005-06
26,47,38,9,0,0020500985,2005-06
27,51,40,11,0,0020500985,2005-06
28,53,43,10,0,0020500985,2005-06
29,53,44,9,0,0020500985,2005-06
30,53,49,4,0,0020500985,2005-06
31,55,52,3,0,0020500985,2005-06
32,57,55,2,0,0020500985,2005-06
33,59,57,2,0,0020500985,2005-06
34,59,64,-5,0,0020500985,2005-06
35,62,64,-2,0,0020500985,2005-06
36,62,67,-5,0,0020500985,2005-06
37,64,69,-5,0,0020500985,2005-06
38,66,71,-5,0,0020500985,2005-06
39,68,71,-3,0,0020500985,2005-06
40,70,71,-1,0,0020500985,2005-06
41,73,74,-1,0,0020500985,2005-06
42,74,76,-2,0,0020500985,2005-06
43,74,78,-4,0,0020500985,2005-06
44,76,78,-2,0,0020500985,2005-06
45,76,78,-2,0,0020500985,2005-06
46,76,83,-7,0,0020500985,2005-06
47,78,83,-5,0,0020500985,2005-06
48,84,90,-6,0,0020500985,2005-06
49,84,90,-6,0,0020500985,2005-06
1,3,0,3,0,0020800581,2008-09
2,3,2,1,0,0020800581,2008-09
3,3,2,1,0,0020800581,2008-09
4,5,4,1,0,0020800581,2008-09
5,7,6,1,0,0020800581,2008-09
6,9,8,1,0,0020800581,2008-09
7,13,10,3,0,0020800581,2008-09
8,16,12,4,0,0020800581,2008-09
9,16,17,-1,0,0020800581,2008-09
10,16,19,-3,0,0020800581,2008-09
11,18,21,-3,0,0020800581,2008-09
12,18,25,-7,0,0020800581,2008-09
13,21,30,-9,0,0020800581,2008-09
14,23,30,-7,0,0020800581,2008-09
15,30,30,0,0,0020800581,2008-09
16,32,33,-1,0,0020800581,2008-09
17,32,36,-4,0,0020800581,2008-09
18,32,39,-7,0,0020800581,2008-09
19,34,41,-7,0,0020800581,2008-09
20,36,41,-5,0,0020800581,2008-09
21,37,43,-6,0,0020800581,2008-09
22,40,46,-6,0,0020800581,2008-09
23,42,48,-6,0,0020800581,2008-09
24,47,51,-4,0,0020800581,2008-09
25,49,56,-7,0,0020800581,2008-09
26,51,60,-9,0,0020800581,2008-09
27,51,62,-11,0,0020800581,2008-09
28,55,64,-9,0,0020800581,2008-09
29,55,66,-11,0,0020800581,2008-09
30,55,70,-15,0,0020800581,2008-09
31,57,73,-16,0,0020800581,2008-09
32,61,75,-14,0,0020800581,2008-09
33,64,79,-15,0,0020800581,2008-09
34,66,79,-13,0,0020800581,2008-09
35,68,81,-13,0,0020800581,2008-09
36,70,85,-15,0,0020800581,2008-09
37,70,87,-17,0,0020800581,2008-09
38,70,89,-19,0,0020800581,2008-09
39,74,89,-15,0,0020800581,2008-09
40,74,93,-19,0,0020800581,2008-09
41,74,97,-23,0,0020800581,2008-09
42,74,97,-23,0,0020800581,2008-09
43,76,101,-25,0,0020800581,2008-09
44,78,101,-23,0,0020800581,2008-09
45,83,103,-20,0,0020800581,2008-09
46,85,106,-21,0,0020800581,2008-09
47,85,109,-24,0,0020800581,2008-09
48,87,109,-22,0,0020800581,2008-09
49,87,109,-22,0,0020800581,2008-09
1,4,2,2,0,0021300706,2013-14
2,6,6,0,0,0021300706,2013-14
3,10,8,2,0,0021300706,2013-14
4,13,13,0,0,0021300706,2013-14
5,13,13,0,0,0021300706,2013-14
6,16,17,-1,0,0021300706,2013-14
7,16,19,-3,0,0021300706,2013-14
8,16,23,-7,0,0021300706,2013-14
9,16,23,-7,0,0021300706,2013-14
10,20,28,-8,0,0021300706,2013-14
11,25,28,-3,0,0021300706,2013-14
12,27,32,-5,0,0021300706,2013-14
13,27,34,-7,0,0021300706,2013-14
14,27,37,-10,0,0021300706,2013-14
15,30,41,-11,0,0021300706,2013-14
16,35,41,-6,0,0021300706,2013-14
17,35,47,-12,0,0021300706,2013-14
18,36,48,-12,0,0021300706,2013-14
19,41,50,-9,0,0021300706,2013-14
20,41,50,-9,0,0021300706,2013-14
21,41,52,-11,0,0021300706,2013-14
22,41,57,-16,0,0021300706,2013-14
23,41,57,-16,0,0021300706,2013-14
24,41,59,-18,0,0021300706,2013-14
25,41,59,-18,0,0021300706,2013-14
26,42,61,-19,0,0021300706,2013-14
27,44,66,-22,0,0021300706,2013-14
28,48,68,-20,0,0021300706,2013-14
29,53,68,-15,0,0021300706,2013-14
30,55,73,-18,0,0021300706,2013-14
31,55,75,-20,0,0021300706,2013-14
32,55,78,-23,0,0021300706,2013-14
33,57,80,-23,0,0021300706,2013-14
34,60,82,-22,0,0021300706,2013-14
35,62,86,-24,0,0021300706,2013-14
36,63,90,-27,0,0021300706,2013-14
37,69,90,-21,0,0021300706,2013-14
38,71,90,-19,0,0021300706,2013-14
39,71,94,-23,0,0021300706,2013-14
40,74,96,-22,0,0021300706,2013-14
41,78,96,-18,0,0021300706,2013-14
42,80,99,-19,0,0021300706,2013-14
43,82,99,-17,0,0021300706,2013-14
44,84,99,-15,0,0021300706,2013-14
45,86,101,-15,0,0021300706,2013-14
46,88,103,-15,0,0021300706,2013-14
47,90,105,-15,0,0021300706,2013-14
48,95,105,-10,0,0021300706,2013-14
49,95,105,-10,0,0021300706,2013-14
1,2,3,-1,1,0029600839,1996-97
2,2,5,-3,1,0029600839,1996-97
3,5,7,-2,1,0029600839,1996-97
4,9,9,0,1,0029600839,1996-97
5,9,14,-5,1,0029600839,1996-97
6,11,16,-5,1,0029600839,1996-97
7,13,20,-7,1,0029600839,1996-97
8,13,24,-11,1,0029600839,1996-97
9,15,27,-12,1,0029600839,1996-97
10,19,27,-8,1,0029600839,1996-97
11,23,27,-4,1,0029600839,1996-97
12,26,29,-3,1,0029600839,1996-97
13,26,31,-5,1,0029600839,1996-97
14,30,31,-1,1,0029600839,1996-97
15,34,31,3,1,0029600839,1996-97
16,36,33,3,1,0029600839,1996-97
17,38,37,1,1,0029600839,1996-97
18,40,41,-1,1,0029600839,1996-97
19,42,45,-3,1,0029600839,1996-97
20,46,50,-4,1,0029600839,1996-97
21,48,53,-5,1,0029600839,1996-97
22,53,53,0,1,0029600839,1996-97
23,55,55,0,1,0029600839,1996-97
24,57,55,2,1,0029600839,1996-97
25,57,57,0,1,0029600839,1996-97
26,57,59,-2,1,0029600839,1996-97
27,59,59,0,1,0029600839,1996-97
28,63,61,2,1,0029600839,1996-97
29,63,61,2,1,0029600839,1996-97
30,67,63,4,1,0029600839,1996-97
31,67,69,-2,1,0029600839,1996-97
32,71,71,0,1,0029600839,1996-97
33,73,73,0,1,0029600839,1996-97
34,76,75,1,1,0029600839,1996-97
35,78,78,0,1,0029600839,1996-97
36,83,81,2,1,0029600839,1996-97
37,83,85,-2,1,0029600839,1996-97
38,88,87,1,1,0029600839,1996-97
39,92,89,3,1,0029600839,1996-97
40,92,91,1,1,0029600839,1996-97
41,92,93,-1,1,0029600839,1996-97
42,96,95,1,1,0029600839,1996-97
43,96,97,-1,1,0029600839,1996-97
44,96,97,-1,1,0029600839,1996-97
45,98,100,-2,1,0029600839,1996-97
46,100,101,-1,1,0029600839,1996-97
47,100,103,-3,1,0029600839,1996-97
48,107,106,1,1,0029600839,1996-97
49,107,106,1,1,0029600839,1996-97
1,0,0,0,0,0029900335,1999-00
2,3,2,1,0,0029900335,1999-00
3,5,4,1,0,0029900335,1999-00
4,9,6,3,0,0029900335,1999-00
5,11,8,3,0,0029900335,1999-00
6,15,8,7,0,0029900335,1999-00
7,17,12,5,0,0029900335,1999-00
8,17,16,1,0,0029900335,1999-00
9,21,20,1,0,0029900335,1999-00
10,21,22,-1,0,0029900335,1999-00
11,25,24,1,0,0029900335,1999-00
12,25,27,-2,0,0029900335,1999-00
13,29,32,-3,0,0029900335,1999-00
14,31,34,-3,0,0029900335,1999-00
15,33,37,-4,0,0029900335,1999-00
16,35,40,-5,0,0029900335,1999-00
17,35,44,-9,0,0029900335,1999-00
18,35,47,-12,0,0029900335,1999-00
19,35,50,-15,0,0029900335,1999-00
20,37,53,-16,0,0029900335,1999-00
21,39,58,-19,0,0029900335,1999-00
22,43,60,-17,0,0029900335,1999-00
23,45,60,-15,0,0029900335,1999-00
24,46,62,-16,0,0029900335,1999-00
25,48,64,-16,0,0029900335,1999-00
26,50,66,-16,0,0029900335,1999-00
27,50,70,-20,0,0029900335,1999-00
28,50,73,-23,0,0029900335,1999-00
29,52,75,-23,0,0029900335,1999-00
30,55,76,-21,0,0029900335,1999-00
31,59,78,-19,0,0029900335,1999-00
32,61,79,-18,0,0029900335,1999-00
33,61,79,-18,0,0029900335,1999-00
34,65,80,-15,0,0029900335,1999-00
35,65,82,-17,0,0029900335,1999-00
36,65,83,-18,0,0029900335,1999-00
37,65,83,-18,0,0029900335,1999-00
38,69,83,-14,0,0029900335,1999-00
39,71,85,-14,0,0029900335,1999-00
40,75,85,-10,0,0029900335,1999-00
41,76,89,-13,0,0029900335,1999-00
42,80,90,-10,0,0029900335,1999-00
43,81,94,-13,0,0029900335,1999-00
44,85,94,-9,0,0029900335,1999-00
45,87,94,-7,0,0029900335,1999-00
46,87,96,-9,0,0029900335,1999-00
47,89,97,-8,0,0029900335,1999-00
48,91,104,-13,0,0029900335,1999-00
49,91,104,-13,0,0029900335,1999-00
1,0,2,-2,1,0021600568,2016-17
2,5,4,1,1,0021600568,2016-17
3,5,9,-4,1,0021600568,2016-17
4,5,12,-7,1,0021600568,2016-17
5,8,12,-4,1,0021600568,2016-17
6,12,14,-2,1,0021600568,2016-17
7,14,16,-2,1,0021600568,2016-17
8,19,18,1,1,0021600568,2016-17
9,22,20,2,1,0021600568,2016-17
10,24,20,4,1,0021600568,2016-17
11,27,23,4,1,0021600568,2016-17
12,29,26,3,1,0021600568,2016-17
13,29,28,1,1,0021600568,2016-17
14,32,30,2,1,0021600568,2016-17
15,35,33,2,1,0021600568,2016-17
16,39,33,6,1,0021600568,2016-17
17,42,38,4,1,0021600568,2016-17
18,42,41,1,1,0021600568,2016-17
19,46,41,5,1,0021600568,2016-17
20,50,41,9,1,0021600568,2016-17
21,50,43,7,1,0021600568,2016-17
22,53,45,8,1,0021600568,2016-17
23,58,48,10,1,0021600568,2016-17
24,60,51,9,1,0021600568,2016-17
25,64,51,13,1,0021600568,2016-17
26,64,53,11,1,0021600568,2016-17
27,66,56,10,1,0021600568,2016-17
28,66,58,8,1,0021600568,2016-17
29,70,58,12,1,0021600568,2016-17
30,72,61,11,1,0021600568,2016-17
31,76,61,15,1,0021600568,2016-17
32,79,61,18,1,0021600568,2016-17
33,82,63,19,1,0021600568,2016-17
34,85,63,22,1,0021600568,2016-17
35,87,63,24,1,0021600568,2016-17
36,91,66,25,1,0021600568,2016-17
37,93,69,24,1,0021600568,2016-17
38,95,69,26,1,0021600568,2016-17
39,97,71,26,1,0021600568,2016-17
40,97,71,26,1,0021600568,2016-17
41,101,73,28,1,0021600568,2016-17
42,102,75,27,1,0021600568,2016-17
43,106,77,29,1,0021600568,2016-17
44,106,82,24,1,0021600568,2016-17
45,106,87,19,1,0021600568,2016-17
46,108,91,17,1,0021600568,2016-17
47,110,94,16,1,0021600568,2016-17
48,110,96,14,1,0021600568,2016-17
49,110,96,14,1,0021600568,2016-17
1,3,3,0,1,0021500388,2015-16
2,3,5,-2,1,0021500388,2015-16
3,5,7,-2,1,0021500388,2015-16
4,9,11,-2,1,0021500388,2015-16
5,14,11,3,1,0021500388,2015-16
6,16,11,5,1,0021500388,2015-16
7,18,13,5,1,0021500388,2015-16
8,22,13,9,1,0021500388,2015-16
9,24,15,9,1,0021500388,2015-16
10,26,17,9,1,0021500388,2015-16
11,30,21,9,1,0021500388,2015-16
12,30,21,9,1,0021500388,2015-16
13,34,23,11,1,0021500388,2015-16
14,38,26,12,1,0021500388,2015-16
15,42,28,14,1,0021500388,2015-16
16,42,30,12,1,0021500388,2015-16
17,46,32,14,1,0021500388,2015-16
18,50,34,16,1,0021500388,2015-16
19,53,34,19,1,0021500388,2015-16
20,56,36,20,1,0021500388,2015-16
21,57,40,17,1,0021500388,2015-16
22,61,40,21,1,0021500388,2015-16
23,65,44,21,1,0021500388,2015-16
24,65,44,21,1,0021500388,2015-16
25,65,46,19,1,0021500388,2015-16
26,68,48,20,1,0021500388,2015-16
27,70,53,17,1,0021500388,2015-16
28,74,53,21,1,0021500388,2015-16
29,74,53,21,1,0021500388,2015-16
30,76,55,21,1,0021500388,2015-16
31,80,58,22,1,0021500388,2015-16
32,85,58,27,1,0021500388,2015-16
33,86,62,24,1,0021500388,2015-16
34,86,64,22,1,0021500388,2015-16
35,86,64,22,1,0021500388,2015-16
36,89,68,21,1,0021500388,2015-16
37,93,68,25,1,0021500388,2015-16
38,98,68,30,1,0021500388,2015-16
39,98,73,25,1,0021500388,2015-16
40,100,75,25,1,0021500388,2015-16
41,103,78,25,1,0021500388,2015-16
42,103,80,23,1,0021500388,2015-16
43,105,82,23,1,0021500388,2015-16
44,105,83,22,1,0021500388,2015-16
45,105,85,20,1,0021500388,2015-16
46,107,89,18,1,0021500388,2015-16
47,107,91,16,1,0021500388,2015-16
48,107,94,13,1,0021500388,2015-16
49,107,97,10,1,0021500388,2015-16
1,0,2,-2,0,0020100522,2001-02
2,2,4,-2,0,0020100522,2001-02
3,2,11,-9,0,0020100522,2001-02
4,5,11,-6,0,0020100522,2001-02
5,9,13,-4,0,0020100522,2001-02
6,9,15,-6,0,0020100522,2001-02
7,9,17,-8,0,0020100522,2001-02
8,13,17,-4,0,0020100522,2001-02
9,15,17,-2,0,0020100522,2001-02
10,17,17,0,0,0020100522,2001-02
11,21,19,2,0,0020100522,2001-02
12,24,23,1,0,0020100522,2001-02
13,28,25,3,0,0020100522,2001-02
14,30,27,3,0,0020100522,2001-02
15,31,31,0,0,0020100522,2001-02
16,34,33,1,0,0020100522,2001-02
17,35,35,0,0,0020100522,2001-02
18,35,38,-3,0,0020100522,2001-02
19,35,42,-7,0,0020100522,2001-02
20,37,44,-7,0,0020100522,2001-02
21,39,46,-7,0,0020100522,2001-02
22,40,48,-8,0,0020100522,2001-02
23,42,52,-10,0,0020100522,2001-02
24,46,55,-9,0,0020100522,2001-02
25,48,55,-7,0,0020100522,2001-02
26,50,57,-7,0,0020100522,2001-02
27,52,57,-5,0,0020100522,2001-02
28,54,61,-7,0,0020100522,2001-02
29,56,64,-8,0,0020100522,2001-02
30,56,66,-10,0,0020100522,2001-02
31,56,68,-12,0,0020100522,2001-02
32,59,68,-9,0,0020100522,2001-02
33,61,70,-9,0,0020100522,2001-02
34,61,72,-11,0,0020100522,2001-02
35,65,74,-9,0,0020100522,2001-02
36,67,76,-9,0,0020100522,2001-02
37,72,80,-8,0,0020100522,2001-02
38,75,80,-5,0,0020100522,2001-02
39,77,80,-3,0,0020100522,2001-02
40,79,81,-2,0,0020100522,2001-02
41,81,84,-3,0,0020100522,2001-02
42,81,86,-5,0,0020100522,2001-02
43,83,88,-5,0,0020100522,2001-02
44,85,91,-6,0,0020100522,2001-02
45,87,91,-4,0,0020100522,2001-02
46,91,91,0,0,0020100522,2001-02
47,96,95,1,0,0020100522,2001-02
48,97,99,-2,0,0020100522,2001-02
49,97,99,-2,0,0020100522,2001-02
1,0,2,-2,1,0022100716,2021-22
2,0,7,-7,1,0022100716,2021-22
3,0,7,-7,1,0022100716,2021-22
4,2,11,-9,1,0022100716,2021-22
5,2,13,-11,1,0022100716,2021-22
6,2,17,-15,1,0022100716,2021-22
7,6,21,-15,1,0022100716,2021-22
8,8,26,-18,1,0022100716,2021-22
9,13,26,-13,1,0022100716,2021-22
10,19,28,-9,1,0022100716,2021-22
11,21,30,-9,1,0022100716,2021-22
12,23,32,-9,1,0022100716,2021-22
13,23,34,-11,1,0022100716,2021-22
14,25,39,-14,1,0022100716,2021-22
15,25,41,-16,1,0022100716,2021-22
16,25,44,-19,1,0022100716,2021-22
17,25,47,-22,1,0022100716,2021-22
18,25,51,-26,1,0022100716,2021-22
19,25,54,-29,1,0022100716,2021-22
20,27,58,-31,1,0022100716,2021-22
21,27,60,-33,1,0022100716,2021-22
22,31,62,-31,1,0022100716,2021-22
23,31,66,-35,1,0022100716,2021-22
24,36,66,-30,1,0022100716,2021-22
25,40,68,-28,1,0022100716,2021-22
26,45,70,-25,1,0022100716,2021-22
27,45,72,-27,1,0022100716,2021-22
28,48,74,-26,1,0022100716,2021-22
29,54,75,-21,1,0022100716,2021-22
30,58,77,-19,1,0022100716,2021-22
31,60,82,-22,1,0022100716,2021-22
32,60,85,-25,1,0022100716,2021-22
33,63,87,-24,1,0022100716,2021-22
34,65,89,-24,1,0022100716,2021-22
35,71,91,-20,1,0022100716,2021-22
36,76,93,-17,1,0022100716,2021-22
37,81,93,-12,1,0022100716,2021-22
38,83,94,-11,1,0022100716,2021-22
39,86,94,-8,1,0022100716,2021-22
40,86,96,-10,1,0022100716,2021-22
41,88,98,-10,1,0022100716,2021-22
42,91,100,-9,1,0022100716,2021-22
43,91,102,-11,1,0022100716,2021-22
44,96,105,-9,1,0022100716,2021-22
45,101,105,-4,1,0022100716,2021-22
46,105,108,-3,1,0022100716,2021-22
47,105,111,-6,1,0022100716,2021-22
48,116,115,1,1,0022100716,2021-22
49,116,115,1,1,0022100716,2021-22
1,4,2,2,1,0020100576,2001-02
2,4,4,0,1,0020100576,2001-02
3,6,6,0,1,0020100576,2001-02
4,8,6,2,1,0020100576,2001-02
5,11,8,3,1,0020100576,2001-02
6,11,10,1,1,0020100576,2001-02
7,11,10,1,1,0020100576,2001-02
8,13,13,0,1,0020100576,2001-02
9,15,15,0,1,0020100576,2001-02
10,15,19,-4,1,0020100576,2001-02
11,17,23,-6,1,0020100576,2001-02
12,21,23,-2,1,0020100576,2001-02
13,24,25,-1,1,0020100576,2001-02
14,26,29,-3,1,0020100576,2001-02
15,26,29,-3,1,0020100576,2001-02
16,31,29,2,1,0020100576,2001-02
17,31,31,0,1,0020100576,2001-02
18,33,35,-2,1,0020100576,2001-02
19,35,37,-2,1,0020100576,2001-02
20,37,39,-2,1,0020100576,2001-02
21,40,41,-1,1,0020100576,2001-02
22,45,43,2,1,0020100576,2001-02
23,47,48,-1,1,0020100576,2001-02
24,50,54,-4,1,0020100576,2001-02
25,52,54,-2,1,0020100576,2001-02
26,54,56,-2,1,0020100576,2001-02
27,58,56,2,1,0020100576,2001-02
28,58,56,2,1,0020100576,2001-02
29,58,58,0,1,0020100576,2001-02
30,60,58,2,1,0020100576,2001-02
31,62,58,4,1,0020100576,2001-02
32,64,58,6,1,0020100576,2001-02
33,64,62,2,1,0020100576,2001-02
34,67,64,3,1,0020100576,2001-02
35,69,66,3,1,0020100576,2001-02
36,71,68,3,1,0020100576,2001-02
37,73,70,3,1,0020100576,2001-02
38,77,70,7,1,0020100576,2001-02
39,77,75,2,1,0020100576,2001-02
40,77,77,0,1,0020100576,2001-02
41,78,79,-1,1,0020100576,2001-02
42,80,82,-2,1,0020100576,2001-02
43,82,82,0,1,0020100576,2001-02
44,87,84,3,1,0020100576,2001-02
45,91,86,5,1,0020100576,2001-02
46,93,88,5,1,0020100576,2001-02
47,94,92,2,1,0020100576,2001-02
48,100,99,1,1,0020100576,2001-02
49,101,99,2,1,0020100576,2001-02
1,0,0,0,0,0020200508,2002-03
3,3,2,1,0,0020200508,2002-03
4,5,4,1,0,0020200508,2002-03
5,7,8,-1,0,0020200508,2002-03
6,7,8,-1,0,0020200508,2002-03
7,11,12,-1,0,0020200508,2002-03
8,13,16,-3,0,0020200508,2002-03
9,13,21,-8,0,0020200508,2002-03
10,13,24,-11,0,0020200508,2002-03
11,13,24,-11,0,0020200508,2002-03
12,13,24,-11,0,0020200508,2002-03
13,13,24,-11,0,0020200508,2002-03
14,13,26,-13,0,0020200508,2002-03
15,18,30,-12,0,0020200508,2002-03
16,20,30,-10,0,0020200508,2002-03
17,20,32,-12,0,0020200508,2002-03
18,20,33,-13,0,0020200508,2002-03
19,23,35,-12,0,0020200508,2002-03
20,25,37,-12,0,0020200508,2002-03
21,26,39,-13,0,0020200508,2002-03
22,26,41,-15,0,0020200508,2002-03
23,27,43,-16,0,0020200508,2002-03
24,31,45,-14,0,0020200508,2002-03
25,31,47,-16,0,0020200508,2002-03
26,33,49,-16,0,0020200508,2002-03
27,34,49,-15,0,0020200508,2002-03
28,38,49,-11,0,0020200508,2002-03
29,38,49,-11,0,0020200508,2002-03
30,41,49,-8,0,0020200508,2002-03
31,46,49,-3,0,0020200508,2002-03
32,49,49,0,0,0020200508,2002-03
33,49,52,-3,0,0020200508,2002-03
34,53,55,-2,0,0020200508,2002-03
35,55,58,-3,0,0020200508,2002-03
36,59,63,-4,0,0020200508,2002-03
37,61,65,-4,0,0020200508,2002-03
38,64,65,-1,0,0020200508,2002-03
39,64,66,-2,0,0020200508,2002-03
40,64,68,-4,0,0020200508,2002-03
41,64,72,-8,0,0020200508,2002-03
42,66,74,-8,0,0020200508,2002-03
43,66,76,-10,0,0020200508,2002-03
44,68,77,-9,0,0020200508,2002-03
45,70,78,-8,0,0020200508,2002-03
46,74,80,-6,0,0020200508,2002-03
47,75,80,-5,0,0020200508,2002-03
48,75,84,-9,0,0020200508,2002-03
49,75,84,-9,0,0020200508,2002-03
1,2,3,-1,0,0021000401,2010-11
2,4,5,-1,0,0021000401,2010-11
3,8,7,1,0,0021000401,2010-11
4,10,9,1,0,0021000401,2010-11
5,14,9,5,0,0021000401,2010-11
6,14,11,3,0,0021000401,2010-11
7,19,13,6,0,0021000401,2010-11
8,23,15,8,0,0021000401,2010-11
9,23,17,6,0,0021000401,2010-11
10,26,19,7,0,0021000401,2010-11
11,28,21,7,0,0021000401,2010-11
12,30,23,7,0,0021000401,2010-11
13,32,25,7,0,0021000401,2010-11
14,32,25,7,0,0021000401,2010-11
15,34,29,5,0,0021000401,2010-11
16,34,31,3,0,0021000401,2010-11
17,35,34,1,0,0021000401,2010-11
18,35,36,-1,0,0021000401,2010-11
19,37,36,1,0,0021000401,2010-11
20,41,36,5,0,0021000401,2010-11
21,41,37,4,0,0021000401,2010-11
22,41,41,0,0,0021000401,2010-11
23,43,43,0,0,0021000401,2010-11
24,43,43,0,0,0021000401,2010-11
25,43,45,-2,0,0021000401,2010-11
26,46,45,1,0,0021000401,2010-11
27,49,45,4,0,0021000401,2010-11
28,54,47,7,0,0021000401,2010-11
29,54,49,5,0,0021000401,2010-11
30,56,51,5,0,0021000401,2010-11
31,58,53,5,0,0021000401,2010-11
32,58,55,3,0,0021000401,2010-11
33,60,58,2,0,0021000401,2010-11
34,62,60,2,0,0021000401,2010-11
35,62,60,2,0,0021000401,2010-11
36,62,62,0,0,0021000401,2010-11
37,62,62,0,0,0021000401,2010-11
38,64,66,-2,0,0021000401,2010-11
39,64,71,-7,0,0021000401,2010-11
40,64,71,-7,0,0021000401,2010-11
41,66,71,-5,0,0021000401,2010-11
42,70,74,-4,0,0021000401,2010-11
43,70,78,-8,0,0021000401,2010-11
44,70,80,-10,0,0021000401,2010-11
45,73,80,-7,0,0021000401,2010-11
46,73,83,-10,0,0021000401,2010-11
47,78,87,-9,0,0021000401,2010-11
48,82,89,-7,0,0021000401,2010-11
49,82,89,-7,0,0021000401,2010-11
1,2,1,1,0,0021500713,2015-16
2,4,8,-4,0,0021500713,2015-16
3,6,13,-7,0,0021500713,2015-16
4,9,13,-4,0,0021500713,2015-16
5,11,15,-4,0,0021500713,2015-16
6,13,19,-6,0,0021500713,2015-16
7,15,23,-8,0,0021500713,2015-16
8,17,23,-6,0,0021500713,2015-16
9,19,26,-7,0,0021500713,2015-16
10,22,28,-6,0,0021500713,2015-16
11,26,33,-7,0,0021500713,2015-16
12,30,35,-5,0,0021500713,2015-16
13,32,39,-7,0,0021500713,2015-16
14,32,44,-12,0,0021500713,2015-16
15,34,46,-12,0,0021500713,2015-16
16,36,46,-10,0,0021500713,2015-16
17,36,48,-12,0,0021500713,2015-16
18,40,50,-10,0,0021500713,2015-16
19,43,52,-9,0,0021500713,2015-16
20,45,56,-11,0,0021500713,2015-16
21,46,56,-10,0,0021500713,2015-16
22,46,62,-16,0,0021500713,2015-16
23,47,64,-17,0,0021500713,2015-16
24,49,66,-17,0,0021500713,2015-16
25,51,66,-15,0,0021500713,2015-16
26,55,66,-11,0,0021500713,2015-16
27,57,66,-9,0,0021500713,2015-16
28,57,68,-11,0,0021500713,2015-16
29,57,72,-15,0,0021500713,2015-16
30,61,74,-13,0,0021500713,2015-16
31,64,76,-12,0,0021500713,2015-16
32,66,78,-12,0,0021500713,2015-16
33,67,84,-17,0,0021500713,2015-16
34,71,88,-17,0,0021500713,2015-16
35,71,88,-17,0,0021500713,2015-16
36,76,92,-16,0,0021500713,2015-16
37,78,94,-16,0,0021500713,2015-16
38,80,94,-14,0,0021500713,2015-16
39,82,94,-12,0,0021500713,2015-16
40,84,96,-12,0,0021500713,2015-16
41,86,101,-15,0,0021500713,2015-16
42,91,105,-14,0,0021500713,2015-16
43,93,110,-17,0,0021500713,2015-16
44,95,113,-18,0,0021500713,2015-16
45,98,115,-17,0,0021500713,2015-16
46,98,117,-19,0,0021500713,2015-16
47,99,117,-18,0,0021500713,2015-16
48,103,117,-14,0,0021500713,2015-16
49,103,117,-14,0,0021500713,2015-16
